"name","taxonomy_id","taxonomy_lvl","kraken_assigned_reads","added_reads","new_est_reads","fraction_total_reads","sample"
"Blautia.sp..SC05B48",2479767,"S",115,1057,1172,0.03875,"030161"
"X.Ruminococcus..gnavus",33038,"S",176,783,959,0.03171,"030161"
"X.Clostridium..hylemonae",89153,"S",89,104,193,0.00638,"030161"
"X.Clostridium..scindens",29347,"S",2,6,8,0.00026,"030161"
"Anaerobutyricum.hallii",39488,"S",88,258,346,0.01144,"030161"
"Anaerostipes.hadrus",649756,"S",22,104,126,0.00417,"030161"
"Anaerostipes.caccae",105841,"S",1,2,3,1e-04,"030161"
"Coprococcus.comes",410072,"S",4,23,27,0.00089,"030161"
"Flavonifractor.plautii",292800,"S",143,747,890,0.02942,"030161"
"Faecalibacterium.prausnitzii",853,"S",84,739,823,0.02721,"030161"
"Ruminococcus.bicirculans",1160721,"S",14,66,80,0.00264,"030161"
"Oscillibacter.sp..MM59",2714358,"S",5,51,56,0.00185,"030161"
"Ruthenibacterium.lactatiformans",1550024,"S",6,27,33,0.00109,"030161"
"Peptacetobacter.hiranonis",89152,"S",784,1385,2169,0.07171,"030161"
"Intestinimonas.butyriciproducens",1297617,"S",165,479,644,0.02129,"030161"
"Flintibacter.sp..KGMB00164",2610895,"S",36,80,116,0.00384,"030161"
"Massilistercora.timonensis",2086584,"S",4,34,38,0.00126,"030161"
"Christensenella.sp..Marseille.P3954",2086585,"S",1,2,3,1e-04,"030161"
"Limosilactobacillus.fermentum",1613,"S",2,7,9,3e-04,"030161"
"Erysipelatoclostridium.ramosum",1547,"S",9,11,20,0.00066,"030161"
"X.Clostridium..innocuum",1522,"S",5,10,15,5e-04,"030161"
"Longicatena.caecimuris",1796635,"S",4,15,19,0.00063,"030161"
"Collinsella.aerofaciens",74426,"S",773,1051,1824,0.0603,"030161"
"Gordonibacter.pamelaeae",471189,"S",2,28,30,0.00099,"030161"
"Phocaeicola.dorei",357276,"S",1644,1524,3168,0.10474,"030161"
"Bacteroides.ovatus",28116,"S",613,1307,1920,0.06348,"030161"
"Bacteroides.cellulosilyticus",246787,"S",176,77,253,0.00836,"030161"
"Bacteroides.salyersiae",291644,"S",1,0,1,3e-05,"030161"
"Alistipes.onderdonkii",328813,"S",1467,3631,5098,0.16855,"030161"
"Alistipes.finegoldii",214856,"S",136,667,803,0.02655,"030161"
"Parabacteroides.merdae",46503,"S",568,345,913,0.03018,"030161"
"Parabacteroides.distasonis",823,"S",36,475,511,0.01689,"030161"
"Fusobacterium.mortiferum",850,"S",482,4437,4919,0.16263,"030161"
"Desulfovibrio.fairfieldensis",44742,"S",121,444,565,0.01868,"030161"
"Akkermansia.muciniphila",239935,"S",724,302,1026,0.03392,"030161"
"Homo.sapiens",9606,"S",1364,85,1449,0.04791,"030161"
"Phocaeicola.dorei",357276,"S",1588,1106,2694,0.10861,"030163"
"Phocaeicola.vulgatus",821,"S",1,0,1,4e-05,"030163"
"Bacteroides.ovatus",28116,"S",652,908,1560,0.06289,"030163"
"Bacteroides.cellulosilyticus",246787,"S",138,49,187,0.00754,"030163"
"Alistipes.onderdonkii",328813,"S",1194,2280,3474,0.14005,"030163"
"Alistipes.finegoldii",214856,"S",119,631,750,0.03024,"030163"
"Parabacteroides.merdae",46503,"S",561,330,891,0.03592,"030163"
"Parabacteroides.distasonis",823,"S",21,342,363,0.01463,"030163"
"Gemmatirosa.kalamazoonesis",861299,"S",1,2,3,0.00012,"030163"
"Blautia.sp..SC05B48",2479767,"S",161,1087,1248,0.05031,"030163"
"Blautia.argi",1912897,"S",2,4,6,0.00024,"030163"
"X.Ruminococcus..gnavus",33038,"S",216,682,898,0.0362,"030163"
"Anaerobutyricum.hallii",39488,"S",97,214,311,0.01254,"030163"
"X.Clostridium..hylemonae",89153,"S",53,59,112,0.00452,"030163"
"X.Clostridium..scindens",29347,"S",1,2,3,0.00012,"030163"
"Anaerostipes.hadrus",649756,"S",26,80,106,0.00427,"030163"
"Anaerostipes.caccae",105841,"S",1,1,2,8e-05,"030163"
"Coprococcus.comes",410072,"S",5,21,26,0.00105,"030163"
"Lachnospira.eligens",39485,"S",1,0,1,4e-05,"030163"
"Peptacetobacter.hiranonis",89152,"S",422,565,987,0.03979,"030163"
"Flavonifractor.plautii",292800,"S",64,265,329,0.01326,"030163"
"Faecalibacterium.prausnitzii",853,"S",59,383,442,0.01782,"030163"
"Ruminococcus.bicirculans",1160721,"S",10,39,49,0.00198,"030163"
"Oscillibacter.sp..MM59",2714358,"S",5,29,34,0.00137,"030163"
"Ruthenibacterium.lactatiformans",1550024,"S",2,7,9,0.00036,"030163"
"Intestinimonas.butyriciproducens",1297617,"S",145,307,452,0.01822,"030163"
"Flintibacter.sp..KGMB00164",2610895,"S",25,39,64,0.00258,"030163"
"Limosilactobacillus.fermentum",1613,"S",1,3,4,0.00016,"030163"
"Erysipelatoclostridium.ramosum",1547,"S",6,8,14,0.00056,"030163"
"X.Clostridium..innocuum",1522,"S",3,3,6,0.00024,"030163"
"Longicatena.caecimuris",1796635,"S",3,7,10,4e-04,"030163"
"Collinsella.aerofaciens",74426,"S",615,807,1422,0.05733,"030163"
"Gordonibacter.pamelaeae",471189,"S",2,17,19,0.00077,"030163"
"Fusobacterium.mortiferum",850,"S",292,2675,2967,0.11961,"030163"
"Desulfovibrio.fairfieldensis",44742,"S",38,137,175,0.00706,"030163"
"Pectobacterium.parmentieri",1905730,"S",1,0,1,4e-05,"030163"
"Akkermansia.muciniphila",239935,"S",344,126,470,0.01895,"030163"
"Homo.sapiens",9606,"S",4154,543,4697,0.18936,"030163"
"Homo.sapiens",9606,"S",10914,804,11718,0.89772,"030165"
"Faecalibacterium.prausnitzii",853,"S",10,600,610,0.04673,"030165"
"Flavonifractor.plautii",292800,"S",1,14,15,0.00115,"030165"
"X.Ruminococcus..torques",33039,"S",3,62,65,0.00498,"030165"
"Anaerobutyricum.hallii",39488,"S",2,36,38,0.00291,"030165"
"X.Clostridium..hylemonae",89153,"S",1,6,7,0.00054,"030165"
"Lachnospira.eligens",39485,"S",1,13,14,0.00107,"030165"
"Coprococcus.comes",410072,"S",1,54,55,0.00421,"030165"
"Blautia.sp..SC05B48",2479767,"S",1,30,31,0.00237,"030165"
"Peptoniphilus.harei",54005,"S",1,92,93,0.00712,"030165"
"Collinsella.aerofaciens",74426,"S",3,54,57,0.00437,"030165"
"Bacteroides.cellulosilyticus",246787,"S",4,58,62,0.00475,"030165"
"Phocaeicola.vulgatus",821,"S",11,240,251,0.01923,"030165"
"Parabacteroides.merdae",46503,"S",2,28,30,0.0023,"030165"
"Homo.sapiens",9606,"S",6238,988,7226,1,"030167"
"Homo.sapiens",9606,"S",5328,727,6055,0.99671,"030169"
"Moraxella.osloensis",34062,"S",9,6,15,0.00247,"030169"
"Flavobacterium.indicum",312277,"S",1,0,1,0.00016,"030169"
"Bacteroides.salyersiae",291644,"S",1,1,2,0.00033,"030169"
"Homo.sapiens",9606,"S",4515,1103,5618,0.98561,"030171"
"Anaerostipes.hadrus",649756,"S",2,12,14,0.00246,"030171"
"Anaerobutyricum.hallii",39488,"S",1,3,4,7e-04,"030171"
"Faecalibacterium.prausnitzii",853,"S",1,12,13,0.00228,"030171"
"Longicatena.caecimuris",1796635,"S",2,9,11,0.00193,"030171"
"Phascolarctobacterium.sp..Marseille.Q4147",2823317,"S",1,0,1,0.00018,"030171"
"Finegoldia.magna",1260,"S",1,7,8,0.0014,"030171"
"Collinsella.aerofaciens",74426,"S",1,2,3,0.00053,"030171"
"Deinococcus.radiopugnans",57497,"S",1,4,5,0.00088,"030171"
"Prevotella.copri",165179,"S",1,5,6,0.00105,"030171"
"Phocaeicola.vulgatus",821,"S",1,3,4,7e-04,"030171"
"Alistipes.finegoldii",214856,"S",1,2,3,0.00053,"030171"
"Alistipes.onderdonkii",328813,"S",1,1,2,0.00035,"030171"
"Akkermansia.muciniphila",239935,"S",2,1,3,0.00053,"030171"
"Flavonifractor.plautii",292800,"S",2,47,49,0.10865,"030173"
"Acutalibacter.muris",1796620,"S",1,2,3,0.00665,"030173"
"Flintibacter.sp..KGMB00164",2610895,"S",1,32,33,0.07317,"030173"
"Faecalibaculum.rodentium",1702221,"S",2,5,7,0.01552,"030173"
"Parvimonas.micra",33033,"S",2,175,177,0.39246,"030173"
"Moraxella.osloensis",34062,"S",7,130,137,0.30377,"030173"
"Muribaculum.gordoncarteri",2530390,"S",1,27,28,0.06208,"030173"
"Homo.sapiens",9606,"S",1,12,13,0.02882,"030173"
"Homo.sapiens",9606,"S",7452,575,8027,0.8221,"030295"
"X.Ruminococcus..gnavus",33038,"S",85,380,465,0.04762,"030295"
"Blautia.argi",1912897,"S",17,110,127,0.01301,"030295"
"X.Clostridium..hylemonae",89153,"S",5,2,7,0.00072,"030295"
"X.Clostridium..scindens",29347,"S",4,12,16,0.00164,"030295"
"Lachnoclostridium.phocaeense",1871021,"S",1,5,6,0.00061,"030295"
"Lacrimispora.saccharolytica",84030,"S",6,28,34,0.00348,"030295"
"Anaerostipes.caccae",105841,"S",1,1,2,2e-04,"030295"
"Fastidiosipila.sanguinis",236753,"S",27,66,93,0.00952,"030295"
"Flavonifractor.plautii",292800,"S",7,21,28,0.00287,"030295"
"Ruthenibacterium.lactatiformans",1550024,"S",3,8,11,0.00113,"030295"
"Monoglobus.pectinilyticus",1981510,"S",2,35,37,0.00379,"030295"
"Solibaculum.mannosilyticum",2780922,"S",1,4,5,0.00051,"030295"
"Flintibacter.sp..KGMB00164",2610895,"S",20,29,49,0.00502,"030295"
"Intestinimonas.butyriciproducens",1297617,"S",1,2,3,0.00031,"030295"
"Nosocomiicoccus.ampullae",489910,"S",1,0,1,1e-04,"030295"
"Peptoniphilus.ivorii",54006,"S",1,3,4,0.00041,"030295"
"Anaerococcus.mediterraneensis",1870984,"S",1,6,7,0.00072,"030295"
"Mobiluncus.curtisii",2051,"S",2,10,12,0.00123,"030295"
"Lawsonella.clevelandensis",1528099,"S",1,1,2,2e-04,"030295"
"Porphyromonas.asaccharolytica",28123,"S",1,66,67,0.00686,"030295"
"Akkermansia.glycaniphila",1679444,"S",382,356,738,0.07558,"030295"
"Moraxella.osloensis",34062,"S",9,4,13,0.00133,"030295"
"Bacteroides.salyersiae",291644,"S",446,579,1025,0.04192,"030297"
"Bacteroides.caccae",47678,"S",180,230,410,0.01677,"030297"
"Bacteroides.uniformis",820,"S",61,966,1027,0.042,"030297"
"Bacteroides.cellulosilyticus",246787,"S",19,28,47,0.00192,"030297"
"Bacteroides.ovatus",28116,"S",3,62,65,0.00266,"030297"
"Phocaeicola.vulgatus",821,"S",497,760,1257,0.05141,"030297"
"Phocaeicola.dorei",357276,"S",417,599,1016,0.04155,"030297"
"Prevotella.oris",28135,"S",1161,377,1538,0.0629,"030297"
"Prevotella.nigrescens",28133,"S",868,572,1440,0.05889,"030297"
"Prevotella.sp..oral.taxon.475",712471,"S",8,2,10,0.00041,"030297"
"Alistipes.onderdonkii",328813,"S",351,449,800,0.03272,"030297"
"Alistipes.finegoldii",214856,"S",62,122,184,0.00753,"030297"
"Alistipes.indistinctus",626932,"S",15,6,21,0.00086,"030297"
"Alistipes.shahii",328814,"S",14,29,43,0.00176,"030297"
"Parabacteroides.merdae",46503,"S",70,216,286,0.0117,"030297"
"Parabacteroides.goldsteinii",328812,"S",21,29,50,0.00204,"030297"
"Odoribacter.splanchnicus",28118,"S",116,23,139,0.00568,"030297"
"Butyricimonas.virosa",544645,"S",65,21,86,0.00352,"030297"
"Porphyromonas.asaccharolytica",28123,"S",1,0,1,4e-05,"030297"
"Oscillibacter.sp..MM59",2714358,"S",9,399,408,0.01669,"030297"
"Faecalibacterium.prausnitzii",853,"S",230,1159,1389,0.05681,"030297"
"Flavonifractor.plautii",292800,"S",13,35,48,0.00196,"030297"
"Ruminococcus.bicirculans",1160721,"S",2,2,4,0.00016,"030297"
"Ruthenibacterium.lactatiformans",1550024,"S",2,9,11,0.00045,"030297"
"Fastidiosipila.sanguinis",236753,"S",1,44,45,0.00184,"030297"
"Coprococcus.catus",116085,"S",335,603,938,0.03836,"030297"
"Coprococcus.comes",410072,"S",15,53,68,0.00278,"030297"
"X.Ruminococcus..torques",33039,"S",160,741,901,0.03685,"030297"
"X.Clostridium..hylemonae",89153,"S",44,19,63,0.00258,"030297"
"X.Clostridium..scindens",29347,"S",22,32,54,0.00221,"030297"
"Anaerostipes.hadrus",649756,"S",23,72,95,0.00389,"030297"
"Anaerobutyricum.hallii",39488,"S",6,8,14,0.00057,"030297"
"Blautia.sp..SC05B48",2479767,"S",3,16,19,0.00078,"030297"
"Blautia.producta",33035,"S",1,0,1,4e-05,"030297"
"Blautia.obeum",40520,"S",1,4,5,2e-04,"030297"
"Hungatella.hathewayi",154046,"S",9,2,11,0.00045,"030297"
"Sarcina.sp..JB2",2726954,"S",2,2,4,0.00016,"030297"
"Flintibacter.sp..KGMB00164",2610895,"S",11,10,21,0.00086,"030297"
"Massilistercora.timonensis",2086584,"S",1,5,6,0.00025,"030297"
"Dialister.pneumosintes",39950,"S",969,1602,2571,0.10515,"030297"
"X.Clostridium..innocuum",1522,"S",31,73,104,0.00425,"030297"
"Erysipelatoclostridium.ramosum",1547,"S",8,7,15,0.00061,"030297"
"Finegoldia.magna",1260,"S",2,7,9,0.00037,"030297"
"Peptoniphilus.harei",54005,"S",2,6,8,0.00033,"030297"
"Gordonibacter.urolithinfaciens",1335613,"S",1,44,45,0.00184,"030297"
"Collinsella.aerofaciens",74426,"S",42,77,119,0.00487,"030297"
"Lancefieldella.parvula",1382,"S",1,0,1,4e-05,"030297"
"Cutibacterium.modestum",2559073,"S",2,3,5,2e-04,"030297"
"Fusobacterium.nucleatum",851,"S",1052,1216,2268,0.09276,"030297"
"Leptotrichia.wadei",157687,"S",1,0,1,4e-05,"030297"
"Escherichia.coli",562,"S",2,226,228,0.00932,"030297"
"Yersinia.enterocolitica",630,"S",1,2,3,0.00012,"030297"
"Akkermansia.muciniphila",239935,"S",65,21,86,0.00352,"030297"
"Homo.sapiens",9606,"S",4639,771,5410,0.22126,"030297"
"Homo.sapiens",9606,"S",12733,880,13613,0.92587,"030299"
"Bacteroides.salyersiae",291644,"S",86,197,283,0.01925,"030299"
"Bacteroides.caccae",47678,"S",6,2,8,0.00054,"030299"
"Phocaeicola.vulgatus",821,"S",3,7,10,0.00068,"030299"
"Phocaeicola.dorei",357276,"S",1,2,3,2e-04,"030299"
"Porphyromonas.asaccharolytica",28123,"S",41,14,55,0.00374,"030299"
"Porphyromonas.cangingivalis",36874,"S",2,1,3,2e-04,"030299"
"Prevotella.oris",28135,"S",1,9,10,0.00068,"030299"
"Anaerobutyricum.hallii",39488,"S",1,16,17,0.00116,"030299"
"X.Ruminococcus..torques",33039,"S",1,36,37,0.00252,"030299"
"Hungatella.hathewayi",154046,"S",8,10,18,0.00122,"030299"
"Oscillibacter.sp..MM50",2714355,"S",1,26,27,0.00184,"030299"
"Faecalibacterium.prausnitzii",853,"S",1,35,36,0.00245,"030299"
"Flavonifractor.plautii",292800,"S",1,8,9,0.00061,"030299"
"Dialister.pneumosintes",39950,"S",20,56,76,0.00517,"030299"
"Megamonas.funiformis",437897,"S",1,2,3,2e-04,"030299"
"Erysipelatoclostridium.ramosum",1547,"S",1,9,10,0.00068,"030299"
"Mobiluncus.curtisii",2051,"S",14,14,28,0.0019,"030299"
"Fusobacterium.nucleatum",851,"S",140,160,300,0.0204,"030299"
"Fusobacterium.necrophorum",859,"S",50,68,118,0.00803,"030299"
"Leptotrichia.sp..oral.taxon.212",712357,"S",1,2,3,2e-04,"030299"
"Campylobacter.ureolyticus",827,"S",2,1,3,2e-04,"030299"
"Treponema.sp..OMZ.804",120683,"S",2,12,14,0.00095,"030299"
"Akkermansia.muciniphila",239935,"S",4,3,7,0.00048,"030299"
"Homo.sapiens",9606,"S",7875,1398,9273,0.99198,"030301"
"Faecalibacterium.prausnitzii",853,"S",2,18,20,0.00214,"030301"
"Dialister.pneumosintes",39950,"S",4,6,10,0.00107,"030301"
"Porphyromonas.asaccharolytica",28123,"S",4,3,7,0.00075,"030301"
"Bacteroides.cellulosilyticus",246787,"S",1,12,13,0.00139,"030301"
"Fusobacterium.nucleatum",851,"S",8,12,20,0.00214,"030301"
"Fusobacterium.necrophorum",859,"S",1,1,2,0.00021,"030301"
"Homo.sapiens",9606,"S",4469,289,4758,0.99084,"030303"
"Coprococcus.catus",116085,"S",1,3,4,0.00083,"030303"
"Blautia.sp..SC05B48",2479767,"S",1,6,7,0.00146,"030303"
"Faecalibacterium.prausnitzii",853,"S",1,5,6,0.00125,"030303"
"Parabacteroides.merdae",46503,"S",4,4,8,0.00167,"030303"
"Parabacteroides.goldsteinii",328812,"S",1,0,1,0.00021,"030303"
"Bacteroides.cellulosilyticus",246787,"S",2,0,2,0.00042,"030303"
"Bacteroides.intestinalis",329854,"S",1,0,1,0.00021,"030303"
"Bacteroides.salyersiae",291644,"S",1,0,1,0.00021,"030303"
"Phocaeicola.vulgatus",821,"S",1,0,1,0.00021,"030303"
"Fusobacterium.nucleatum",851,"S",3,4,7,0.00146,"030303"
"Methanobrevibacter.smithii",2173,"S",1,0,1,0.00021,"030303"
"Akkermansia.muciniphila",239935,"S",9981,1097,11078,0.33294,"030305"
"Oscillibacter.sp..MM50",2714355,"S",116,2688,2804,0.08427,"030305"
"Flavonifractor.plautii",292800,"S",135,1068,1203,0.03616,"030305"
"Ruthenibacterium.lactatiformans",1550024,"S",77,415,492,0.01479,"030305"
"Dysosmobacter.sp..Marseille.Q4140",2830675,"S",1,7,8,0.00024,"030305"
"X.Ruminococcus..gnavus",33038,"S",88,525,613,0.01842,"030305"
"Coprococcus.catus",116085,"S",73,392,465,0.01398,"030305"
"Blautia.argi",1912897,"S",15,98,113,0.0034,"030305"
"X.Clostridium..hylemonae",89153,"S",37,25,62,0.00186,"030305"
"Anaerostipes.caccae",105841,"S",8,16,24,0.00072,"030305"
"Anaerotignum.propionicum",28446,"S",4,2,6,0.00018,"030305"
"Flintibacter.sp..KGMB00164",2610895,"S",122,322,444,0.01334,"030305"
"Massilistercora.timonensis",2086584,"S",7,100,107,0.00322,"030305"
"Intestinimonas.butyriciproducens",1297617,"S",1,6,7,0.00021,"030305"
"Clostridium.sp..C1",1155388,"S",3,16,19,0.00057,"030305"
"Hungatella.hathewayi",154046,"S",3,5,8,0.00024,"030305"
"Longicatena.caecimuris",1796635,"S",676,1397,2073,0.0623,"030305"
"Erysipelatoclostridium.ramosum",1547,"S",63,69,132,0.00397,"030305"
"X.Clostridium..innocuum",1522,"S",4,9,13,0.00039,"030305"
"Dialister.pneumosintes",39950,"S",2,173,175,0.00526,"030305"
"Phascolarctobacterium.faecium",33025,"S",18,11,29,0.00087,"030305"
"Parvimonas.micra",33033,"S",1,2,3,9e-05,"030305"
"Gordonibacter.pamelaeae",471189,"S",2,31,33,0.00099,"030305"
"Bacteroides.ovatus",28116,"S",9,2594,2603,0.07823,"030305"
"Phocaeicola.dorei",357276,"S",363,363,726,0.02182,"030305"
"Phocaeicola.vulgatus",821,"S",303,317,620,0.01863,"030305"
"Parabacteroides.merdae",46503,"S",943,1298,2241,0.06735,"030305"
"Parabacteroides.distasonis",823,"S",1,58,59,0.00177,"030305"
"Alistipes.onderdonkii",328813,"S",670,644,1314,0.03949,"030305"
"Alistipes.communis",2585118,"S",233,70,303,0.00911,"030305"
"Alistipes.finegoldii",214856,"S",63,53,116,0.00349,"030305"
"Butyricimonas.faecalis",2093856,"S",35,71,106,0.00319,"030305"
"Sutterella.wadsworthensis",40545,"S",1646,1195,2841,0.08538,"030305"
"Homo.sapiens",9606,"S",2266,152,2418,0.07267,"030305"
"Lachnoanaerobaculum.umeaense",617123,"S",1,3,4,0.2,"030307"
"Corynebacterium.kroppenstedtii",161879,"S",1,0,1,0.05,"030307"
"Corynebacterium.urealyticum",43771,"S",1,3,4,0.2,"030307"
"Homo.sapiens",9606,"S",2,7,9,0.45,"030307"
"Fastidiosipila.sanguinis",236753,"S",8978,4579,13557,0.48567,"030820"
"Flavonifractor.plautii",292800,"S",7,815,822,0.02945,"030820"
"Ruthenibacterium.lactatiformans",1550024,"S",7,66,73,0.00262,"030820"
"Solibaculum.mannosilyticum",2780922,"S",3,7,10,0.00036,"030820"
"X.Ruminococcus..gnavus",33038,"S",138,705,843,0.0302,"030820"
"Blautia.argi",1912897,"S",46,144,190,0.00681,"030820"
"X.Clostridium..scindens",29347,"S",45,103,148,0.0053,"030820"
"X.Clostridium..hylemonae",89153,"S",9,3,12,0.00043,"030820"
"Lachnoclostridium.phocaeense",1871021,"S",3,12,15,0.00054,"030820"
"Lacrimispora.saccharolytica",84030,"S",18,83,101,0.00362,"030820"
"Anaerostipes.caccae",105841,"S",1,1,2,7e-05,"030820"
"Clostridium.butyricum",1492,"S",14,54,68,0.00244,"030820"
"Clostridium.perfringens",1502,"S",1,491,492,0.01763,"030820"
"Flintibacter.sp..KGMB00164",2610895,"S",15,21,36,0.00129,"030820"
"Intestinimonas.butyriciproducens",1297617,"S",6,11,17,0.00061,"030820"
"Veillonella.parvula",29466,"S",1,232,233,0.00835,"030820"
"Peptoniphilus.ivorii",54006,"S",148,92,240,0.0086,"030820"
"Anaerococcus.mediterraneensis",1870984,"S",14,64,78,0.00279,"030820"
"Erysipelatoclostridium.ramosum",1547,"S",4,2,6,0.00021,"030820"
"X.Clostridium..innocuum",1522,"S",1,1,2,7e-05,"030820"
"Mobiluncus.curtisii",2051,"S",315,209,524,0.01877,"030820"
"Lawsonella.clevelandensis",1528099,"S",1,0,1,4e-05,"030820"
"Porphyromonas.asaccharolytica",28123,"S",953,5629,6582,0.2358,"030820"
"Porphyromonas.cangingivalis",36874,"S",2,200,202,0.00724,"030820"
"Akkermansia.glycaniphila",1679444,"S",1109,607,1716,0.06147,"030820"
"Campylobacter.ureolyticus",827,"S",356,189,545,0.01952,"030820"
"Candidatus.Nanosynbacter.lyticus",2093824,"S",1,0,1,4e-05,"030820"
"Homo.sapiens",9606,"S",897,489,1386,0.04965,"030820"
"Homo.sapiens",9606,"S",8602,419,9021,0.54465,"030822"
"X.Clostridium..scindens",29347,"S",26,218,244,0.01473,"030822"
"X.Clostridium..hylemonae",89153,"S",10,8,18,0.00109,"030822"
"Lachnoclostridium.phocaeense",1871021,"S",5,30,35,0.00211,"030822"
"Blautia.sp..SC05B48",2479767,"S",4,83,87,0.00525,"030822"
"Blautia.obeum",40520,"S",1,26,27,0.00163,"030822"
"Coprococcus.comes",410072,"S",3,97,100,0.00604,"030822"
"Coprococcus.catus",116085,"S",1,17,18,0.00109,"030822"
"Anaerostipes.hadrus",649756,"S",2,31,33,0.00199,"030822"
"Anaerostipes.caccae",105841,"S",1,2,3,0.00018,"030822"
"Faecalibacterium.prausnitzii",853,"S",113,376,489,0.02952,"030822"
"Flavonifractor.plautii",292800,"S",92,211,303,0.01829,"030822"
"Ruthenibacterium.lactatiformans",1550024,"S",47,71,118,0.00712,"030822"
"Oscillibacter.sp..MM50",2714355,"S",16,94,110,0.00664,"030822"
"Oscillibacter.sp..MM59",2714358,"S",4,14,18,0.00109,"030822"
"Intestinimonas.butyriciproducens",1297617,"S",28,45,73,0.00441,"030822"
"Flintibacter.sp..KGMB00164",2610895,"S",2,2,4,0.00024,"030822"
"Hungatella.hathewayi",154046,"S",21,6,27,0.00163,"030822"
"Clostridium.sp..C1",1155388,"S",5,9,14,0.00085,"030822"
"Finegoldia.magna",1260,"S",477,547,1024,0.06182,"030822"
"Peptoniphilus.harei",54005,"S",437,498,935,0.05645,"030822"
"Peptoniphilus.ivorii",54006,"S",17,17,34,0.00205,"030822"
"Anaerococcus.prevotii",33034,"S",20,143,163,0.00984,"030822"
"Anaerococcus.mediterraneensis",1870984,"S",1,5,6,0.00036,"030822"
"Murdochiella.vaginalis",1852373,"S",45,45,90,0.00543,"030822"
"Dialister.pneumosintes",39950,"S",23,43,66,0.00398,"030822"
"X.Clostridium..innocuum",1522,"S",46,36,82,0.00495,"030822"
"Erysipelatoclostridium.ramosum",1547,"S",4,2,6,0.00036,"030822"
"Longicatena.caecimuris",1796635,"S",3,4,7,0.00042,"030822"
"Ndongobacter.massiliensis",1871025,"S",2,1,3,0.00018,"030822"
"Lawsonella.clevelandensis",1528099,"S",31,39,70,0.00423,"030822"
"Collinsella.aerofaciens",74426,"S",31,28,59,0.00356,"030822"
"Phocaeicola.vulgatus",821,"S",1266,674,1940,0.11713,"030822"
"Phocaeicola.dorei",357276,"S",104,58,162,0.00978,"030822"
"Bacteroides.uniformis",820,"S",137,404,541,0.03266,"030822"
"Bacteroides.cellulosilyticus",246787,"S",89,34,123,0.00743,"030822"
"Alistipes.finegoldii",214856,"S",42,76,118,0.00712,"030822"
"Alistipes.shahii",328814,"S",25,45,70,0.00423,"030822"
"Alistipes.onderdonkii",328813,"S",5,17,22,0.00133,"030822"
"Alistipes.communis",2585118,"S",1,2,3,0.00018,"030822"
"Porphyromonas.asaccharolytica",28123,"S",22,1,23,0.00139,"030822"
"Parabacteroides.merdae",46503,"S",7,3,10,6e-04,"030822"
"Campylobacter.ureolyticus",827,"S",103,31,134,0.00809,"030822"
"Sutterella.wadsworthensis",40545,"S",1,55,56,0.00338,"030822"
"Akkermansia.muciniphila",239935,"S",42,7,49,0.00296,"030822"
"Methanobrevibacter.smithii",2173,"S",5,0,5,3e-04,"030822"
"Homo.sapiens",9606,"S",7750,767,8517,0.99812,"030824"
"Peptacetobacter.hiranonis",89152,"S",1,2,3,0.00035,"030824"
"Oscillibacter.sp..MM59",2714358,"S",1,6,7,0.00082,"030824"
"Alistipes.communis",2585118,"S",1,2,3,0.00035,"030824"
"Bacteroides.caccae",47678,"S",253,1358,1611,0.04859,"030935"
"Bacteroides.uniformis",820,"S",44,3202,3246,0.09791,"030935"
"Bacteroides.ovatus",28116,"S",1,98,99,0.00299,"030935"
"Phocaeicola.vulgatus",821,"S",2249,3389,5638,0.17007,"030935"
"Parabacteroides.merdae",46503,"S",1059,1600,2659,0.08021,"030935"
"Parabacteroides.goldsteinii",328812,"S",61,32,93,0.00281,"030935"
"Alistipes.communis",2585118,"S",280,477,757,0.02283,"030935"
"Alistipes.shahii",328814,"S",223,860,1083,0.03267,"030935"
"Butyricimonas.faecalis",2093856,"S",364,972,1336,0.0403,"030935"
"Barnesiella.viscericola",397865,"S",157,77,234,0.00706,"030935"
"Oscillibacter.sp..MM50",2714355,"S",988,4636,5624,0.16964,"030935"
"Oscillibacter.sp..MM35",2714353,"S",13,51,64,0.00193,"030935"
"Oscillibacter.sp..MM59",2714358,"S",8,26,34,0.00103,"030935"
"Faecalibacterium.prausnitzii",853,"S",1212,2890,4102,0.12373,"030935"
"Ruminococcus.bicirculans",1160721,"S",555,827,1382,0.04169,"030935"
"Flavonifractor.plautii",292800,"S",71,72,143,0.00431,"030935"
"Ruthenibacterium.lactatiformans",1550024,"S",64,752,816,0.02461,"030935"
"Dysosmobacter.sp..Marseille.Q4140",2830675,"S",26,47,73,0.0022,"030935"
"Dysosmobacter.welbionis",2093857,"S",1,95,96,0.0029,"030935"
"Monoglobus.pectinilyticus",1981510,"S",2,3,5,0.00015,"030935"
"Coprococcus.comes",410072,"S",79,191,270,0.00814,"030935"
"Coprococcus.catus",116085,"S",27,42,69,0.00208,"030935"
"X.Ruminococcus..torques",33039,"S",83,206,289,0.00872,"030935"
"Lachnospira.eligens",39485,"S",83,45,128,0.00386,"030935"
"Blautia.sp..SC05B48",2479767,"S",66,179,245,0.00739,"030935"
"Anaerobutyricum.hallii",39488,"S",36,48,84,0.00253,"030935"
"Anaerostipes.hadrus",649756,"S",18,33,51,0.00154,"030935"
"Lacrimispora.saccharolytica",84030,"S",6,13,19,0.00057,"030935"
"Flintibacter.sp..KGMB00164",2610895,"S",70,44,114,0.00344,"030935"
"Massilistercora.timonensis",2086584,"S",23,60,83,0.0025,"030935"
"Intestinimonas.butyriciproducens",1297617,"S",3,3,6,0.00018,"030935"
"Clostridium.sp..C1",1155388,"S",1,1,2,6e-05,"030935"
"Clostridium.baratii",1561,"S",1,5,6,0.00018,"030935"
"Christensenella.sp..Marseille.P3954",2086585,"S",1,3,4,0.00012,"030935"
"Parvimonas.micra",33033,"S",192,1032,1224,0.03692,"030935"
"Dialister.pneumosintes",39950,"S",4,125,129,0.00389,"030935"
"X.Clostridium..innocuum",1522,"S",26,29,55,0.00166,"030935"
"Erysipelatoclostridium.ramosum",1547,"S",3,1,4,0.00012,"030935"
"Faecalitalea.cylindroides",39483,"S",12,46,58,0.00175,"030935"
"Collinsella.aerofaciens",74426,"S",225,110,335,0.0101,"030935"
"Yersinia.enterocolitica",630,"S",1,1,2,6e-05,"030935"
"Cloacibacillus.porcorum",1197717,"S",32,24,56,0.00169,"030935"
"Akkermansia.muciniphila",239935,"S",1,0,1,3e-05,"030935"
"Homo.sapiens",9606,"S",689,110,799,0.0241,"030935"
"Methanobrevibacter.smithii",2173,"S",5,1,6,0.00018,"030935"
"Bacteroides.salyersiae",291644,"S",150,1337,1487,0.05756,"030937"
"Bacteroides.caccae",47678,"S",48,786,834,0.03229,"030937"
"Bacteroides.cellulosilyticus",246787,"S",9,142,151,0.00585,"030937"
"Bacteroides.uniformis",820,"S",6,1335,1341,0.05191,"030937"
"Bacteroides.ovatus",28116,"S",1,305,306,0.01185,"030937"
"Bacteroides.caecimuris",1796613,"S",1,83,84,0.00325,"030937"
"Phocaeicola.vulgatus",821,"S",169,438,607,0.0235,"030937"
"Phocaeicola.dorei",357276,"S",116,376,492,0.01905,"030937"
"Prevotella.oris",28135,"S",580,128,708,0.02741,"030937"
"Prevotella.nigrescens",28133,"S",341,217,558,0.0216,"030937"
"Prevotella.enoeca",76123,"S",2,0,2,8e-05,"030937"
"Alistipes.finegoldii",214856,"S",67,96,163,0.00631,"030937"
"Alistipes.onderdonkii",328813,"S",64,60,124,0.0048,"030937"
"Alistipes.shahii",328814,"S",3,4,7,0.00027,"030937"
"Alistipes.indistinctus",626932,"S",1,0,1,4e-05,"030937"
"Parabacteroides.merdae",46503,"S",30,158,188,0.00728,"030937"
"Parabacteroides.goldsteinii",328812,"S",4,9,13,5e-04,"030937"
"Butyricimonas.virosa",544645,"S",57,18,75,0.0029,"030937"
"Odoribacter.splanchnicus",28118,"S",59,12,71,0.00275,"030937"
"Porphyromonas.asaccharolytica",28123,"S",1,0,1,4e-05,"030937"
"Fusobacterium.nucleatum",851,"S",4202,3381,7583,0.29355,"030937"
"Leptotrichia.wadei",157687,"S",1,0,1,4e-05,"030937"
"Flavonifractor.plautii",292800,"S",533,939,1472,0.05698,"030937"
"Oscillibacter.sp..MM59",2714358,"S",24,829,853,0.03302,"030937"
"Faecalibacterium.prausnitzii",853,"S",146,1035,1181,0.04572,"030937"
"X.Ruminococcus..torques",33039,"S",111,5572,5683,0.22,"030937"
"Coprococcus.catus",116085,"S",76,234,310,0.012,"030937"
"Coprococcus.comes",410072,"S",2,22,24,0.00093,"030937"
"X.Clostridium..hylemonae",89153,"S",58,13,71,0.00275,"030937"
"X.Clostridium..scindens",29347,"S",15,138,153,0.00592,"030937"
"Blautia.obeum",40520,"S",15,185,200,0.00774,"030937"
"Anaerostipes.hadrus",649756,"S",13,45,58,0.00225,"030937"
"Flintibacter.sp..KGMB00164",2610895,"S",14,11,25,0.00097,"030937"
"Hungatella.hathewayi",154046,"S",8,1,9,0.00035,"030937"
"Dialister.pneumosintes",39950,"S",222,599,821,0.03178,"030937"
"Erysipelatoclostridium.ramosum",1547,"S",5,7,12,0.00046,"030937"
"X.Clostridium..innocuum",1522,"S",4,12,16,0.00062,"030937"
"Collinsella.aerofaciens",74426,"S",15,25,40,0.00155,"030937"
"Sutterella.wadsworthensis",40545,"S",1,0,1,4e-05,"030937"
"Akkermansia.muciniphila",239935,"S",11,8,19,0.00074,"030937"
"Homo.sapiens",9606,"S",33,34,67,0.00259,"030937"
"Bacteroides.cellulosilyticus",246787,"S",1535,1339,2874,0.0846,"030939"
"Bacteroides.uniformis",820,"S",272,2115,2387,0.07026,"030939"
"Bacteroides.intestinalis",329854,"S",156,118,274,0.00807,"030939"
"Bacteroides.caecimuris",1796613,"S",1,3,4,0.00012,"030939"
"Bacteroides.helcogenes",290053,"S",1,0,1,3e-05,"030939"
"Phocaeicola.vulgatus",821,"S",602,1175,1777,0.05231,"030939"
"Phocaeicola.dorei",357276,"S",353,596,949,0.02793,"030939"
"Parabacteroides.merdae",46503,"S",1057,3746,4803,0.14138,"030939"
"Parabacteroides.goldsteinii",328812,"S",21,34,55,0.00162,"030939"
"Parabacteroides.distasonis",823,"S",1,152,153,0.0045,"030939"
"Prevotella.copri",165179,"S",503,742,1245,0.03665,"030939"
"Alistipes.communis",2585118,"S",131,161,292,0.0086,"030939"
"Alistipes.indistinctus",626932,"S",105,42,147,0.00433,"030939"
"Alistipes.sp..dk3624",2662363,"S",83,44,127,0.00374,"030939"
"Alistipes.finegoldii",214856,"S",70,162,232,0.00683,"030939"
"Alistipes.onderdonkii",328813,"S",58,55,113,0.00333,"030939"
"Alistipes.shahii",328814,"S",36,52,88,0.00259,"030939"
"Alistipes.dispar",2585119,"S",5,3,8,0.00024,"030939"
"Butyricimonas.faecalis",2093856,"S",36,103,139,0.00409,"030939"
"Butyricimonas.virosa",544645,"S",17,31,48,0.00141,"030939"
"Odoribacter.splanchnicus",28118,"S",94,26,120,0.00353,"030939"
"Coprobacter.secundus",1501392,"S",4,11,15,0.00044,"030939"
"Porphyromonas.asaccharolytica",28123,"S",3,0,3,9e-05,"030939"
"Faecalibacterium.prausnitzii",853,"S",1550,4522,6072,0.17874,"030939"
"Ruminococcus.bicirculans",1160721,"S",709,704,1413,0.04159,"030939"
"Oscillibacter.sp..MM50",2714355,"S",58,409,467,0.01375,"030939"
"Oscillibacter.sp..MM59",2714358,"S",6,28,34,0.001,"030939"
"Flavonifractor.plautii",292800,"S",7,9,16,0.00047,"030939"
"Ruthenibacterium.lactatiformans",1550024,"S",1,1,2,6e-05,"030939"
"Blautia.sp..SC05B48",2479767,"S",256,1005,1261,0.03712,"030939"
"Blautia.obeum",40520,"S",34,110,144,0.00424,"030939"
"Anaerostipes.hadrus",649756,"S",99,274,373,0.01098,"030939"
"Anaerobutyricum.hallii",39488,"S",90,143,233,0.00686,"030939"
"Lachnospira.eligens",39485,"S",35,30,65,0.00191,"030939"
"X.Ruminococcus..torques",33039,"S",34,94,128,0.00377,"030939"
"Coprococcus.catus",116085,"S",22,45,67,0.00197,"030939"
"Coprococcus.comes",410072,"S",5,18,23,0.00068,"030939"
"Lacrimispora.saccharolytica",84030,"S",6,17,23,0.00068,"030939"
"Clostridium.sp..C1",1155388,"S",133,318,451,0.01328,"030939"
"Hungatella.hathewayi",154046,"S",2,11,13,0.00038,"030939"
"Massilistercora.timonensis",2086584,"S",52,154,206,0.00606,"030939"
"Intestinimonas.butyriciproducens",1297617,"S",16,24,40,0.00118,"030939"
"Flintibacter.sp..KGMB00164",2610895,"S",4,2,6,0.00018,"030939"
"Christensenella.sp..Marseille.P3954",2086585,"S",1,2,3,9e-05,"030939"
"Phascolarctobacterium.sp..Marseille.Q4147",2823317,"S",69,62,131,0.00386,"030939"
"Lactobacillus.jensenii",109790,"S",2,0,2,6e-05,"030939"
"X.Clostridium..innocuum",1522,"S",3,6,9,0.00026,"030939"
"Erysipelatoclostridium.ramosum",1547,"S",3,2,5,0.00015,"030939"
"Collinsella.aerofaciens",74426,"S",392,387,779,0.02293,"030939"
"Gordonibacter.pamelaeae",471189,"S",1,2,3,9e-05,"030939"
"Homo.sapiens",9606,"S",4324,1004,5328,0.15684,"030939"
"Methanobrevibacter.smithii",2173,"S",585,211,796,0.02343,"030939"
"Homo.sapiens",9606,"S",6333,584,6917,0.88014,"030941"
"Bacteroides.caccae",47678,"S",35,56,91,0.01158,"030941"
"Bacteroides.uniformis",820,"S",1,21,22,0.0028,"030941"
"Phocaeicola.vulgatus",821,"S",53,63,116,0.01476,"030941"
"Phocaeicola.dorei",357276,"S",17,17,34,0.00433,"030941"
"Parabacteroides.merdae",46503,"S",55,85,140,0.01781,"030941"
"Alistipes.onderdonkii",328813,"S",21,59,80,0.01018,"030941"
"Alistipes.indistinctus",626932,"S",4,1,5,0.00064,"030941"
"Alistipes.shahii",328814,"S",2,10,12,0.00153,"030941"
"Odoribacter.splanchnicus",28118,"S",70,17,87,0.01107,"030941"
"Butyricimonas.faecalis",2093856,"S",3,5,8,0.00102,"030941"
"Barnesiella.viscericola",397865,"S",10,5,15,0.00191,"030941"
"Oscillibacter.sp..MM50",2714355,"S",3,46,49,0.00623,"030941"
"Flavonifractor.plautii",292800,"S",11,46,57,0.00725,"030941"
"Ruthenibacterium.lactatiformans",1550024,"S",4,17,21,0.00267,"030941"
"Faecalibacterium.prausnitzii",853,"S",3,29,32,0.00407,"030941"
"Lachnospira.eligens",39485,"S",5,18,23,0.00293,"030941"
"Anaerobutyricum.hallii",39488,"S",1,10,11,0.0014,"030941"
"Anaerostipes.hadrus",649756,"S",1,8,9,0.00115,"030941"
"Hungatella.hathewayi",154046,"S",4,4,8,0.00102,"030941"
"Christensenella.minuta",626937,"S",2,13,15,0.00191,"030941"
"Flintibacter.sp..KGMB00164",2610895,"S",1,3,4,0.00051,"030941"
"Phascolarctobacterium.faecium",33025,"S",19,9,28,0.00356,"030941"
"X.Clostridium..innocuum",1522,"S",3,11,14,0.00178,"030941"
"Erysipelatoclostridium.ramosum",1547,"S",2,7,9,0.00115,"030941"
"Longicatena.caecimuris",1796635,"S",4,21,25,0.00318,"030941"
"Collinsella.aerofaciens",74426,"S",5,7,12,0.00153,"030941"
"Methanobrevibacter.smithii",2173,"S",3,1,4,0.00051,"030941"
"Morganella.morganii",582,"S",1,3800,3801,0.15364,"030943"
"Flavonifractor.plautii",292800,"S",319,3029,3348,0.13533,"030943"
"Oscillibacter.sp..MM59",2714358,"S",3,352,355,0.01435,"030943"
"Dysosmobacter.sp..Marseille.Q4140",2830675,"S",14,317,331,0.01338,"030943"
"Ruthenibacterium.lactatiformans",1550024,"S",6,61,67,0.00271,"030943"
"X.Clostridium..scindens",29347,"S",10,469,479,0.01936,"030943"
"X.Clostridium..hylemonae",89153,"S",2,10,12,0.00049,"030943"
"X.Ruminococcus..gnavus",33038,"S",11,470,481,0.01944,"030943"
"Paeniclostridium.sordellii",1505,"S",6,67,73,0.00295,"030943"
"Clostridium.baratii",1561,"S",2,22,24,0.00097,"030943"
"Flintibacter.sp..KGMB00164",2610895,"S",1,7,8,0.00032,"030943"
"Dialister.pneumosintes",39950,"S",9,193,202,0.00816,"030943"
"Megasphaera.stantonii",2144175,"S",1,32,33,0.00133,"030943"
"Erysipelatoclostridium.ramosum",1547,"S",4,220,224,0.00905,"030943"
"X.Clostridium..innocuum",1522,"S",1,139,140,0.00566,"030943"
"Peptoniphilus.harei",54005,"S",1,298,299,0.01209,"030943"
"Collinsella.aerofaciens",74426,"S",49,588,637,0.02575,"030943"
"Bacteroides.salyersiae",291644,"S",7,386,393,0.01589,"030943"
"Phocaeicola.vulgatus",821,"S",39,996,1035,0.04184,"030943"
"Prevotella.oris",28135,"S",1,7,8,0.00032,"030943"
"Fusobacterium.nucleatum",851,"S",67,1465,1532,0.06192,"030943"
"Homo.sapiens",9606,"S",2814,8434,11248,0.45465,"030943"
"Homo.sapiens",9606,"S",4825,1486,6311,0.63587,"030945"
"Flavonifractor.plautii",292800,"S",37,561,598,0.06025,"030945"
"Fastidiosipila.sanguinis",236753,"S",3,168,171,0.01723,"030945"
"Dysosmobacter.sp..Marseille.Q4140",2830675,"S",1,35,36,0.00363,"030945"
"Ruthenibacterium.lactatiformans",1550024,"S",1,15,16,0.00161,"030945"
"Blautia.argi",1912897,"S",1,52,53,0.00534,"030945"
"X.Clostridium..scindens",29347,"S",8,288,296,0.02982,"030945"
"X.Ruminococcus..gnavus",33038,"S",2,70,72,0.00725,"030945"
"Paeniclostridium.sordellii",1505,"S",1,20,21,0.00212,"030945"
"Clostridium.baratii",1561,"S",4,67,71,0.00715,"030945"
"Dialister.pneumosintes",39950,"S",6,240,246,0.02479,"030945"
"Megasphaera.stantonii",2144175,"S",1,53,54,0.00544,"030945"
"X.Clostridium..innocuum",1522,"S",1,23,24,0.00242,"030945"
"Collinsella.aerofaciens",74426,"S",26,480,506,0.05098,"030945"
"Gordonibacter.pamelaeae",471189,"S",1,28,29,0.00292,"030945"
"Escherichia.coli",562,"S",1,242,243,0.02448,"030945"
"Phocaeicola.vulgatus",821,"S",8,247,255,0.02569,"030945"
"Fusobacterium.nucleatum",851,"S",26,869,895,0.09018,"030945"
"Akkermansia.glycaniphila",1679444,"S",1,18,19,0.00191,"030945"
"Homo.sapiens",9606,"S",7169,1354,8523,0.95667,"030947"
"Coprococcus.catus",116085,"S",4,52,56,0.00629,"030947"
"X.Clostridium..hylemonae",89153,"S",1,2,3,0.00034,"030947"
"Anaerobutyricum.hallii",39488,"S",1,9,10,0.00112,"030947"
"Blautia.sp..SC05B48",2479767,"S",1,28,29,0.00326,"030947"
"Lachnospira.eligens",39485,"S",1,10,11,0.00123,"030947"
"Faecalibacterium.prausnitzii",853,"S",3,48,51,0.00572,"030947"
"Oscillibacter.sp..MM35",2714353,"S",2,32,34,0.00382,"030947"
"Dysosmobacter.sp..Marseille.Q4140",2830675,"S",1,10,11,0.00123,"030947"
"Ruminococcus.bicirculans",1160721,"S",1,6,7,0.00079,"030947"
"Ruthenibacterium.lactatiformans",1550024,"S",1,4,5,0.00056,"030947"
"Corynebacterium.urealyticum",43771,"S",1,13,14,0.00157,"030947"
"Collinsella.aerofaciens",74426,"S",2,9,11,0.00123,"030947"
"Fusobacterium.nucleatum",851,"S",1,45,46,0.00516,"030947"
"Bacteroides.salyersiae",291644,"S",2,20,22,0.00247,"030947"
"Phocaeicola.dorei",357276,"S",3,20,23,0.00258,"030947"
"Porphyromonas.asaccharolytica",28123,"S",10,20,30,0.00337,"030947"
"Parabacteroides.goldsteinii",328812,"S",2,4,6,0.00067,"030947"
"Alistipes.onderdonkii",328813,"S",1,6,7,0.00079,"030947"
"Homo.sapiens",9606,"S",3,12,15,1,"031531"
"Fusobacterium.nucleatum",851,"S",5404,24005,29409,0.67466,"031537"
"Selenomonas.sputigena",69823,"S",959,4539,5498,0.12613,"031537"
"Dialister.pneumosintes",39950,"S",38,45,83,0.0019,"031537"
"Veillonella.parvula",29466,"S",1,2,3,7e-05,"031537"
"Phascolarctobacterium.sp..Marseille.Q4147",2823317,"S",13,13,26,6e-04,"031537"
"Lachnoanaerobaculum.umeaense",617123,"S",229,858,1087,0.02494,"031537"
"Anaerostipes.hadrus",649756,"S",16,365,381,0.00874,"031537"
"Lachnospira.eligens",39485,"S",16,154,170,0.0039,"031537"
"Anaerobutyricum.hallii",39488,"S",15,326,341,0.00782,"031537"
"Blautia.sp..SC05B48",2479767,"S",7,353,360,0.00826,"031537"
"Coprococcus.sp..ART55.1",751585,"S",6,140,146,0.00335,"031537"
"X.Ruminococcus..gnavus",33038,"S",2,58,60,0.00138,"031537"
"Clostridium.perfringens",1502,"S",146,809,955,0.02191,"031537"
"Clostridium.sp..C1",1155388,"S",1,35,36,0.00083,"031537"
"Flavonifractor.plautii",292800,"S",116,1798,1914,0.04391,"031537"
"Ruminococcus.bicirculans",1160721,"S",4,52,56,0.00128,"031537"
"Monoglobus.pectinilyticus",1981510,"S",2,61,63,0.00145,"031537"
"Faecalibacterium.prausnitzii",853,"S",1,43,44,0.00101,"031537"
"Oscillibacter.sp..PEA192",2109687,"S",1,84,85,0.00195,"031537"
"Massilistercora.timonensis",2086584,"S",7,440,447,0.01025,"031537"
"Erysipelatoclostridium.ramosum",1547,"S",11,30,41,0.00094,"031537"
"X.Clostridium..innocuum",1522,"S",1,18,19,0.00044,"031537"
"Parvimonas.micra",33033,"S",11,266,277,0.00635,"031537"
"Collinsella.aerofaciens",74426,"S",29,66,95,0.00218,"031537"
"Sutterella.wadsworthensis",40545,"S",50,73,123,0.00282,"031537"
"Bacteroides.uniformis",820,"S",6,708,714,0.01638,"031537"
"Bacteroides.caccae",47678,"S",5,43,48,0.0011,"031537"
"Bacteroides.caecimuris",1796613,"S",1,44,45,0.00103,"031537"
"Phocaeicola.vulgatus",821,"S",55,104,159,0.00365,"031537"
"Phocaeicola.dorei",357276,"S",17,60,77,0.00177,"031537"
"Alistipes.onderdonkii",328813,"S",32,229,261,0.00599,"031537"
"Alistipes.shahii",328814,"S",9,87,96,0.0022,"031537"
"Parabacteroides.merdae",46503,"S",13,97,110,0.00252,"031537"
"Prevotella.veroralis",28137,"S",39,22,61,0.0014,"031537"
"Odoribacter.splanchnicus",28118,"S",1,0,1,2e-05,"031537"
"Akkermansia.muciniphila",239935,"S",45,65,110,0.00252,"031537"
"Homo.sapiens",9606,"S",152,18,170,0.0039,"031537"
"Lachnospira.eligens",39485,"S",26,66,92,0.0239,"031539"
"Anaerostipes.hadrus",649756,"S",21,218,239,0.06209,"031539"
"Blautia.sp..SC05B48",2479767,"S",18,249,267,0.06937,"031539"
"Blautia.obeum",40520,"S",1,17,18,0.00468,"031539"
"Anaerobutyricum.hallii",39488,"S",12,59,71,0.01845,"031539"
"Coprococcus.sp..ART55.1",751585,"S",4,48,52,0.01351,"031539"
"Ruminococcus.bicirculans",1160721,"S",37,121,158,0.04105,"031539"
"Monoglobus.pectinilyticus",1981510,"S",10,91,101,0.02624,"031539"
"Flavonifractor.plautii",292800,"S",5,28,33,0.00857,"031539"
"Faecalibacterium.prausnitzii",853,"S",1,14,15,0.0039,"031539"
"Massilistercora.timonensis",2086584,"S",4,56,60,0.01559,"031539"
"Flintibacter.sp..KGMB00164",2610895,"S",2,6,8,0.00208,"031539"
"Clostridium.perfringens",1502,"S",3,10,13,0.00338,"031539"
"Hungatella.hathewayi",154046,"S",2,2,4,0.00104,"031539"
"Dialister.pneumosintes",39950,"S",2,5,7,0.00182,"031539"
"Selenomonas.sputigena",69823,"S",7,53,60,0.01559,"031539"
"Phascolarctobacterium.sp..Marseille.Q4147",2823317,"S",20,32,52,0.01351,"031539"
"X.Clostridium..innocuum",1522,"S",5,32,37,0.00961,"031539"
"Parvimonas.micra",33033,"S",1,27,28,0.00727,"031539"
"Collinsella.aerofaciens",74426,"S",4,12,16,0.00416,"031539"
"Phocaeicola.vulgatus",821,"S",8,130,138,0.03585,"031539"
"Phocaeicola.dorei",357276,"S",4,67,71,0.01845,"031539"
"Alistipes.shahii",328814,"S",4,138,142,0.03689,"031539"
"Alistipes.onderdonkii",328813,"S",3,68,71,0.01845,"031539"
"Alistipes.indistinctus",626932,"S",1,3,4,0.00104,"031539"
"Parabacteroides.merdae",46503,"S",5,45,50,0.01299,"031539"
"Prevotella.veroralis",28137,"S",2,10,12,0.00312,"031539"
"Odoribacter.splanchnicus",28118,"S",1,2,3,0.00078,"031539"
"Fusobacterium.nucleatum",851,"S",58,454,512,0.13302,"031539"
"Sutterella.wadsworthensis",40545,"S",4,22,26,0.00676,"031539"
"Akkermansia.muciniphila",239935,"S",46,96,142,0.03689,"031539"
"Homo.sapiens",9606,"S",1068,259,1327,0.34476,"031539"
"Homo.sapiens",9606,"S",10048,1600,11648,0.97261,"031541"
"X.Ruminococcus..torques",33039,"S",5,27,32,0.00267,"031541"
"X.Ruminococcus..gnavus",33038,"S",1,4,5,0.00042,"031541"
"X.Clostridium..hylemonae",89153,"S",2,1,3,0.00025,"031541"
"Lachnospira.eligens",39485,"S",1,1,2,0.00017,"031541"
"Flavonifractor.plautii",292800,"S",5,20,25,0.00209,"031541"
"Monoglobus.pectinilyticus",1981510,"S",1,5,6,5e-04,"031541"
"Longicatena.caecimuris",1796635,"S",21,121,142,0.01186,"031541"
"X.Clostridium..innocuum",1522,"S",1,1,2,0.00017,"031541"
"Peptoniphilus.harei",54005,"S",1,7,8,0.00067,"031541"
"Lawsonella.clevelandensis",1528099,"S",10,18,28,0.00234,"031541"
"Alistipes.onderdonkii",328813,"S",9,56,65,0.00543,"031541"
"Moraxella.osloensis",34062,"S",1,2,3,0.00025,"031541"
"Oscillibacter.sp..MM50",2714355,"S",361,3826,4187,0.11018,"031543"
"Oscillibacter.sp..MM59",2714358,"S",42,310,352,0.00926,"031543"
"Faecalibacterium.prausnitzii",853,"S",533,4171,4704,0.12378,"031543"
"Flavonifractor.plautii",292800,"S",138,487,625,0.01645,"031543"
"Ruminococcus.bicirculans",1160721,"S",105,245,350,0.00921,"031543"
"Monoglobus.pectinilyticus",1981510,"S",71,412,483,0.01271,"031543"
"Ruthenibacterium.lactatiformans",1550024,"S",37,125,162,0.00426,"031543"
"Solibaculum.mannosilyticum",2780922,"S",1,6,7,0.00018,"031543"
"Anaerobutyricum.hallii",39488,"S",610,1553,2163,0.05692,"031543"
"Anaerostipes.hadrus",649756,"S",500,2588,3088,0.08126,"031543"
"Lachnospira.eligens",39485,"S",347,530,877,0.02308,"031543"
"X.Clostridium..hylemonae",89153,"S",64,31,95,0.0025,"031543"
"Lachnoclostridium.phocaeense",1871021,"S",10,79,89,0.00234,"031543"
"X.Clostridium..scindens",29347,"S",1,2,3,8e-05,"031543"
"X.Ruminococcus..torques",33039,"S",57,420,477,0.01255,"031543"
"X.Ruminococcus..gnavus",33038,"S",14,68,82,0.00216,"031543"
"Blautia.obeum",40520,"S",19,189,208,0.00547,"031543"
"Blautia.sp..SC05B48",2479767,"S",11,104,115,0.00303,"031543"
"Coprococcus.comes",410072,"S",4,27,31,0.00082,"031543"
"Flintibacter.sp..KGMB00164",2610895,"S",274,630,904,0.02379,"031543"
"Intestinimonas.butyriciproducens",1297617,"S",33,124,157,0.00413,"031543"
"Massilistercora.timonensis",2086584,"S",13,148,161,0.00424,"031543"
"Clostridium.sp..C1",1155388,"S",49,261,310,0.00816,"031543"
"Hungatella.hathewayi",154046,"S",2,1,3,8e-05,"031543"
"Longicatena.caecimuris",1796635,"S",67,449,516,0.01358,"031543"
"Amedibacterium.intestinale",2583452,"S",10,90,100,0.00263,"031543"
"X.Clostridium..innocuum",1522,"S",8,29,37,0.00097,"031543"
"Lancefieldella.parvula",1382,"S",1,1,2,5e-05,"031543"
"Gordonibacter.pamelaeae",471189,"S",16,176,192,0.00505,"031543"
"Gordonibacter.urolithinfaciens",1335613,"S",3,30,33,0.00087,"031543"
"Dietzia.sp..oral.taxon.368",712270,"S",1,1,2,5e-05,"031543"
"Phocaeicola.dorei",357276,"S",1606,2187,3793,0.09981,"031543"
"Phocaeicola.vulgatus",821,"S",777,1096,1873,0.04929,"031543"
"Bacteroides.cellulosilyticus",246787,"S",71,1115,1186,0.03121,"031543"
"Alistipes.onderdonkii",328813,"S",444,825,1269,0.03339,"031543"
"Alistipes.indistinctus",626932,"S",37,22,59,0.00155,"031543"
"Parabacteroides.merdae",46503,"S",344,588,932,0.02452,"031543"
"Akkermansia.muciniphila",239935,"S",2041,978,3019,0.07944,"031543"
"Cloacibacillus.porcorum",1197717,"S",110,177,287,0.00755,"031543"
"Desulfovibrio.desulfuricans",876,"S",66,29,95,0.0025,"031543"
"Campylobacter.ureolyticus",827,"S",2,6,8,0.00021,"031543"
"Fusobacterium.nucleatum",851,"S",18,91,109,0.00287,"031543"
"Homo.sapiens",9606,"S",4633,206,4839,0.12733,"031543"
"Faecalibacterium.prausnitzii",853,"S",426,3647,4073,0.1277,"031545"
"Oscillibacter.sp..MM50",2714355,"S",239,2759,2998,0.094,"031545"
"Oscillibacter.sp..MM59",2714358,"S",13,104,117,0.00367,"031545"
"Flavonifractor.plautii",292800,"S",106,428,534,0.01674,"031545"
"Ruminococcus.bicirculans",1160721,"S",47,141,188,0.00589,"031545"
"Monoglobus.pectinilyticus",1981510,"S",44,278,322,0.0101,"031545"
"Ruthenibacterium.lactatiformans",1550024,"S",39,142,181,0.00567,"031545"
"Solibaculum.mannosilyticum",2780922,"S",1,7,8,0.00025,"031545"
"Anaerobutyricum.hallii",39488,"S",319,897,1216,0.03813,"031545"
"Anaerostipes.hadrus",649756,"S",309,1704,2013,0.06311,"031545"
"Lachnospira.eligens",39485,"S",173,290,463,0.01452,"031545"
"X.Clostridium..hylemonae",89153,"S",40,24,64,0.00201,"031545"
"Lachnoclostridium.phocaeense",1871021,"S",7,60,67,0.0021,"031545"
"X.Clostridium..scindens",29347,"S",4,11,15,0.00047,"031545"
"X.Ruminococcus..torques",33039,"S",39,302,341,0.01069,"031545"
"X.Ruminococcus..gnavus",33038,"S",17,89,106,0.00332,"031545"
"Blautia.obeum",40520,"S",14,140,154,0.00483,"031545"
"Blautia.sp..SC05B48",2479767,"S",7,67,74,0.00232,"031545"
"Coprococcus.comes",410072,"S",3,21,24,0.00075,"031545"
"Flintibacter.sp..KGMB00164",2610895,"S",227,552,779,0.02442,"031545"
"Intestinimonas.butyriciproducens",1297617,"S",25,101,126,0.00395,"031545"
"Massilistercora.timonensis",2086584,"S",14,170,184,0.00577,"031545"
"Clostridium.sp..C1",1155388,"S",27,156,183,0.00574,"031545"
"Longicatena.caecimuris",1796635,"S",24,182,206,0.00646,"031545"
"X.Clostridium..innocuum",1522,"S",10,40,50,0.00157,"031545"
"Amedibacterium.intestinale",2583452,"S",1,9,10,0.00031,"031545"
"Gordonibacter.pamelaeae",471189,"S",8,121,129,0.00404,"031545"
"Gordonibacter.urolithinfaciens",1335613,"S",1,13,14,0.00044,"031545"
"Phocaeicola.dorei",357276,"S",1429,2099,3528,0.11061,"031545"
"Phocaeicola.vulgatus",821,"S",762,1132,1894,0.05938,"031545"
"Bacteroides.cellulosilyticus",246787,"S",33,549,582,0.01825,"031545"
"Alistipes.onderdonkii",328813,"S",321,811,1132,0.03549,"031545"
"Alistipes.indistinctus",626932,"S",18,11,29,0.00091,"031545"
"Parabacteroides.merdae",46503,"S",227,405,632,0.01982,"031545"
"Akkermansia.muciniphila",239935,"S",1578,851,2429,0.07616,"031545"
"Cloacibacillus.porcorum",1197717,"S",69,118,187,0.00586,"031545"
"Desulfovibrio.desulfuricans",876,"S",20,11,31,0.00097,"031545"
"Candidatus.Nanosynbacter.lyticus",2093824,"S",1,2,3,9e-05,"031545"
"Homo.sapiens",9606,"S",5699,1092,6791,0.21292,"031545"
"Porphyromonas.asaccharolytica",28123,"S",7857,3760,11617,0.36198,"031667"
"Porphyromonas.cangingivalis",36874,"S",37,37,74,0.00231,"031667"
"Bacteroides.salyersiae",291644,"S",570,2058,2628,0.08189,"031667"
"Bacteroides.ovatus",28116,"S",152,1345,1497,0.04665,"031667"
"Bacteroides.caecimuris",1796613,"S",1,5,6,0.00019,"031667"
"Phocaeicola.vulgatus",821,"S",286,1449,1735,0.05406,"031667"
"Parabacteroides.goldsteinii",328812,"S",718,671,1389,0.04328,"031667"
"Alistipes.onderdonkii",328813,"S",67,149,216,0.00673,"031667"
"Dysosmobacter.sp..Marseille.Q4140",2830675,"S",1218,4874,6092,0.18982,"031667"
"Ruthenibacterium.lactatiformans",1550024,"S",534,1829,2363,0.07363,"031667"
"Oscillibacter.sp..MM59",2714358,"S",34,260,294,0.00916,"031667"
"Flavonifractor.plautii",292800,"S",1,2,3,9e-05,"031667"
"X.Clostridium..hylemonae",89153,"S",252,321,573,0.01785,"031667"
"X.Clostridium..scindens",29347,"S",12,152,164,0.00511,"031667"
"Anaerostipes.caccae",105841,"S",4,18,22,0.00069,"031667"
"Flintibacter.sp..KGMB00164",2610895,"S",355,674,1029,0.03206,"031667"
"Intestinimonas.butyriciproducens",1297617,"S",89,700,789,0.02458,"031667"
"Hungatella.hathewayi",154046,"S",48,34,82,0.00256,"031667"
"Christensenella.sp..Marseille.P3954",2086585,"S",1,4,5,0.00016,"031667"
"X.Clostridium..innocuum",1522,"S",32,279,311,0.00969,"031667"
"Erysipelatoclostridium.ramosum",1547,"S",25,46,71,0.00221,"031667"
"Longicatena.caecimuris",1796635,"S",17,203,220,0.00686,"031667"
"Anaerococcus.mediterraneensis",1870984,"S",15,241,256,0.00798,"031667"
"Parvimonas.micra",33033,"S",3,59,62,0.00193,"031667"
"Akkermansia.muciniphila",239935,"S",2,2,4,0.00012,"031667"
"Homo.sapiens",9606,"S",119,399,518,0.01614,"031667"
"Methanobrevibacter.smithii",2173,"S",51,11,62,0.00193,"031667"
"Candidatus.Methanomassiliicoccus.intestinalis",1406512,"S",1,0,1,3e-05,"031667"
"Homo.sapiens",9606,"S",10398,466,10864,0.9514,"031669"
"Blautia.argi",1912897,"S",21,89,110,0.00963,"031669"
"X.Ruminococcus..gnavus",33038,"S",10,46,56,0.0049,"031669"
"X.Ruminococcus..torques",33039,"S",6,32,38,0.00333,"031669"
"Anaerostipes.hadrus",649756,"S",15,94,109,0.00955,"031669"
"X.Clostridium..scindens",29347,"S",1,3,4,0.00035,"031669"
"Faecalibacterium.prausnitzii",853,"S",1,16,17,0.00149,"031669"
"Flavonifractor.plautii",292800,"S",1,11,12,0.00105,"031669"
"Intestinimonas.butyriciproducens",1297617,"S",2,10,12,0.00105,"031669"
"Flintibacter.sp..KGMB00164",2610895,"S",2,5,7,0.00061,"031669"
"Longicatena.caecimuris",1796635,"S",14,89,103,0.00902,"031669"
"X.Clostridium..innocuum",1522,"S",1,1,2,0.00018,"031669"
"Lawsonella.clevelandensis",1528099,"S",2,9,11,0.00096,"031669"
"Bacteroides.salyersiae",291644,"S",1,35,36,0.00315,"031669"
"Phocaeicola.dorei",357276,"S",1,4,5,0.00044,"031669"
"Alistipes.onderdonkii",328813,"S",5,9,14,0.00123,"031669"
"Parabacteroides.goldsteinii",328812,"S",3,3,6,0.00053,"031669"
"Neorhizobium.sp..NCHU2750",1825976,"S",1,3,4,0.00035,"031669"
"Bacteroides.cellulosilyticus",246787,"S",224,6144,6368,0.22805,"031671"
"Bacteroides.caecimuris",1796613,"S",3,433,436,0.01561,"031671"
"Bacteroides.zhangwenhongi",2650157,"S",1,65,66,0.00236,"031671"
"Phocaeicola.dorei",357276,"S",643,2147,2790,0.09991,"031671"
"Phocaeicola.vulgatus",821,"S",1,3,4,0.00014,"031671"
"Porphyromonas.sp..oral.taxon.275",712435,"S",2947,1225,4172,0.14941,"031671"
"Porphyromonas.asaccharolytica",28123,"S",1,0,1,4e-05,"031671"
"Odoribacter.splanchnicus",28118,"S",2065,702,2767,0.09909,"031671"
"Alistipes.onderdonkii",328813,"S",82,641,723,0.02589,"031671"
"Fusobacterium.nucleatum",851,"S",2,1191,1193,0.04272,"031671"
"Fusobacterium.hwasookii",1583098,"S",1,2833,2834,0.10149,"031671"
"Ruthenibacterium.lactatiformans",1550024,"S",395,533,928,0.03323,"031671"
"Flavonifractor.plautii",292800,"S",251,732,983,0.0352,"031671"
"Dysosmobacter.sp..Marseille.Q4140",2830675,"S",1,5,6,0.00021,"031671"
"Blautia.argi",1912897,"S",1,20,21,0.00075,"031671"
"X.Ruminococcus..gnavus",33038,"S",12,80,92,0.00329,"031671"
"Clostridium.baratii",1561,"S",4,7,11,0.00039,"031671"
"Veillonella.parvula",29466,"S",5,315,320,0.01146,"031671"
"X.Clostridium..innocuum",1522,"S",14,37,51,0.00183,"031671"
"Erysipelatoclostridium.ramosum",1547,"S",11,9,20,0.00072,"031671"
"Finegoldia.magna",1260,"S",1,7,8,0.00029,"031671"
"Lawsonella.clevelandensis",1528099,"S",2,19,21,0.00075,"031671"
"Homo.sapiens",9606,"S",3632,465,4097,0.14672,"031671"
"Dialister.pneumosintes",39950,"S",574,450,1024,0.0415,"031673"
"Selenomonas.sputigena",69823,"S",54,41,95,0.00385,"031673"
"Bulleidia.sp..zg.1006",2806552,"S",508,2484,2992,0.12125,"031673"
"X.Clostridium..scindens",29347,"S",2,8,10,0.00041,"031673"
"X.Clostridium..hylemonae",89153,"S",1,0,1,4e-05,"031673"
"Lachnoanaerobaculum.umeaense",617123,"S",3,14,17,0.00069,"031673"
"Lachnospira.eligens",39485,"S",3,9,12,0.00049,"031673"
"Coprococcus.comes",410072,"S",1,13,14,0.00057,"031673"
"Faecalibacterium.prausnitzii",853,"S",6,75,81,0.00328,"031673"
"Fastidiosipila.sanguinis",236753,"S",2,22,24,0.00097,"031673"
"Flavonifractor.plautii",292800,"S",1,7,8,0.00032,"031673"
"Clostridium.perfringens",1502,"S",10,43,53,0.00215,"031673"
"Parvimonas.micra",33033,"S",110,2828,2938,0.11906,"031673"
"Peptoniphilus.harei",54005,"S",1,15,16,0.00065,"031673"
"Mobiluncus.curtisii",2051,"S",249,254,503,0.02038,"031673"
"Schaalia.turicensis",131111,"S",119,230,349,0.01414,"031673"
"Lawsonella.clevelandensis",1528099,"S",3,1,4,0.00016,"031673"
"Corynebacterium.matruchotii",43768,"S",1,0,1,4e-05,"031673"
"Capnocytophaga.gingivalis",1017,"S",22,1978,2000,0.08105,"031673"
"Prevotella.oris",28135,"S",216,239,455,0.01844,"031673"
"Prevotella.veroralis",28137,"S",101,118,219,0.00888,"031673"
"Prevotella.nigrescens",28133,"S",6,26,32,0.0013,"031673"
"Prevotella.denticola",28129,"S",4,7,11,0.00045,"031673"
"Prevotella.copri",165179,"S",1,16,17,0.00069,"031673"
"Bacteroides.salyersiae",291644,"S",3,101,104,0.00421,"031673"
"Phocaeicola.vulgatus",821,"S",7,153,160,0.00648,"031673"
"Parabacteroides.merdae",46503,"S",1,34,35,0.00142,"031673"
"Tannerella.sp..oral.taxon.HOT.286",712710,"S",1,2,3,0.00012,"031673"
"Porphyromonas.asaccharolytica",28123,"S",2,2,4,0.00016,"031673"
"Butyricimonas.virosa",544645,"S",1,1,2,8e-05,"031673"
"Fusobacterium.nucleatum",851,"S",568,637,1205,0.04883,"031673"
"Campylobacter.ureolyticus",827,"S",241,207,448,0.01816,"031673"
"Treponema.socranskii",53419,"S",35,163,198,0.00802,"031673"
"Akkermansia.muciniphila",239935,"S",21,8,29,0.00118,"031673"
"Akkermansia.glycaniphila",1679444,"S",1,0,1,4e-05,"031673"
"Homo.sapiens",9606,"S",9494,2097,11591,0.46973,"031673"
"Homo.sapiens",9606,"S",11783,1430,13213,0.90898,"031675"
"Prevotella.nigrescens",28133,"S",58,63,121,0.00832,"031675"
"Prevotella.veroralis",28137,"S",52,25,77,0.0053,"031675"
"Prevotella.oris",28135,"S",25,9,34,0.00234,"031675"
"Prevotella.copri",165179,"S",2,2,4,0.00028,"031675"
"Bacteroides.salyersiae",291644,"S",4,12,16,0.0011,"031675"
"Bacteroides.caccae",47678,"S",2,5,7,0.00048,"031675"
"Bacteroides.cellulosilyticus",246787,"S",1,3,4,0.00028,"031675"
"Phocaeicola.vulgatus",821,"S",13,25,38,0.00261,"031675"
"Parabacteroides.merdae",46503,"S",1,6,7,0.00048,"031675"
"Tannerella.sp..oral.taxon.HOT.286",712710,"S",1,0,1,7e-05,"031675"
"Porphyromonas.asaccharolytica",28123,"S",1,0,1,7e-05,"031675"
"Capnocytophaga.gingivalis",1017,"S",7,221,228,0.01569,"031675"
"Faecalibacterium.prausnitzii",853,"S",39,139,178,0.01225,"031675"
"Oscillibacter.sp..MM50",2714355,"S",4,23,27,0.00186,"031675"
"Lachnospira.eligens",39485,"S",6,5,11,0.00076,"031675"
"Anaerobutyricum.hallii",39488,"S",1,1,2,0.00014,"031675"
"Anaerostipes.hadrus",649756,"S",1,2,3,0.00021,"031675"
"Coprococcus.comes",410072,"S",1,3,4,0.00028,"031675"
"Clostridium.perfringens",1502,"S",1,2,3,0.00021,"031675"
"Limosilactobacillus.mucosae",97478,"S",1,0,1,7e-05,"031675"
"Dialister.pneumosintes",39950,"S",21,49,70,0.00482,"031675"
"Selenomonas.sputigena",69823,"S",9,4,13,0.00089,"031675"
"Bulleidia.sp..zg.1006",2806552,"S",49,78,127,0.00874,"031675"
"Parvimonas.micra",33033,"S",4,110,114,0.00784,"031675"
"Schaalia.turicensis",131111,"S",13,20,33,0.00227,"031675"
"Mobiluncus.curtisii",2051,"S",4,2,6,0.00041,"031675"
"Lancefieldella.parvula",1382,"S",1,0,1,7e-05,"031675"
"Collinsella.aerofaciens",74426,"S",1,0,1,7e-05,"031675"
"Fusobacterium.nucleatum",851,"S",37,30,67,0.00461,"031675"
"Leptotrichia.wadei",157687,"S",1,26,27,0.00186,"031675"
"Akkermansia.muciniphila",239935,"S",36,9,45,0.0031,"031675"
"Treponema.socranskii",53419,"S",2,23,25,0.00172,"031675"
"Campylobacter.ureolyticus",827,"S",8,5,13,0.00089,"031675"
"Leptotrichia.wadei",157687,"S",5299,2789,8088,0.23002,"031677"
"Leptotrichia.sp..oral.taxon.212",712357,"S",1,0,1,3e-05,"031677"
"Fusobacterium.nucleatum",851,"S",4013,2111,6124,0.17417,"031677"
"Prevotella.nigrescens",28133,"S",2353,3467,5820,0.16552,"031677"
"Prevotella.oris",28135,"S",1283,458,1741,0.04951,"031677"
"Prevotella.denticola",28129,"S",415,656,1071,0.03046,"031677"
"Prevotella.dentalis",52227,"S",6,2,8,0.00023,"031677"
"Bacteroides.salyersiae",291644,"S",177,208,385,0.01095,"031677"
"Bacteroides.caccae",47678,"S",43,75,118,0.00336,"031677"
"Bacteroides.cellulosilyticus",246787,"S",19,37,56,0.00159,"031677"
"Bacteroides.uniformis",820,"S",4,96,100,0.00284,"031677"
"Phocaeicola.dorei",357276,"S",184,204,388,0.01103,"031677"
"Parabacteroides.goldsteinii",328812,"S",51,116,167,0.00475,"031677"
"Parabacteroides.merdae",46503,"S",4,17,21,6e-04,"031677"
"Parabacteroides.distasonis",823,"S",1,203,204,0.0058,"031677"
"Odoribacter.splanchnicus",28118,"S",91,9,100,0.00284,"031677"
"Butyricimonas.faecalis",2093856,"S",29,70,99,0.00282,"031677"
"Alistipes.onderdonkii",328813,"S",52,58,110,0.00313,"031677"
"Alistipes.shahii",328814,"S",16,20,36,0.00102,"031677"
"Porphyromonas.asaccharolytica",28123,"S",4,0,4,0.00011,"031677"
"Dialister.pneumosintes",39950,"S",461,560,1021,0.02904,"031677"
"Selenomonas.sputigena",69823,"S",807,324,1131,0.03217,"031677"
"Phascolarctobacterium.sp..Marseille.Q4147",2823317,"S",11,108,119,0.00338,"031677"
"Lachnoanaerobaculum.umeaense",617123,"S",609,531,1140,0.03242,"031677"
"X.Clostridium..scindens",29347,"S",25,191,216,0.00614,"031677"
"X.Ruminococcus..gnavus",33038,"S",7,87,94,0.00267,"031677"
"Clostridium.perfringens",1502,"S",46,75,121,0.00344,"031677"
"Oscillibacter.sp..MM50",2714355,"S",17,261,278,0.00791,"031677"
"Flavonifractor.plautii",292800,"S",4,44,48,0.00137,"031677"
"Flintibacter.sp..KGMB00164",2610895,"S",17,54,71,0.00202,"031677"
"Intestinimonas.butyriciproducens",1297617,"S",2,7,9,0.00026,"031677"
"Limosilactobacillus.mucosae",97478,"S",1,229,230,0.00654,"031677"
"Parvimonas.micra",33033,"S",856,2502,3358,0.0955,"031677"
"Peptoniphilus.harei",54005,"S",32,124,156,0.00444,"031677"
"Finegoldia.magna",1260,"S",10,656,666,0.01894,"031677"
"X.Clostridium..innocuum",1522,"S",148,1009,1157,0.0329,"031677"
"Erysipelatoclostridium.ramosum",1547,"S",76,229,305,0.00867,"031677"
"Lancefieldella.parvula",1382,"S",2,56,58,0.00165,"031677"
"Mobiluncus.curtisii",2051,"S",10,45,55,0.00156,"031677"
"Schaalia.turicensis",131111,"S",1,22,23,0.00065,"031677"
"Treponema.socranskii",53419,"S",1,25,26,0.00074,"031677"
"Homo.sapiens",9606,"S",52,165,217,0.00617,"031677"
"Phocaeicola.vulgatus",821,"S",6600,4600,11200,0.33772,"031679"
"Phocaeicola.dorei",357276,"S",1161,821,1982,0.05976,"031679"
"Prevotella.copri",165179,"S",2324,570,2894,0.08726,"031679"
"Prevotella.intermedia",28131,"S",1,1,2,6e-05,"031679"
"Alistipes.onderdonkii",328813,"S",933,522,1455,0.04387,"031679"
"Veillonella.parvula",29466,"S",52,843,895,0.02699,"031679"
"X.Ruminococcus..gnavus",33038,"S",1025,2117,3142,0.09474,"031679"
"Anaerostipes.caccae",105841,"S",12,9,21,0.00063,"031679"
"X.Clostridium..hylemonae",89153,"S",1,0,1,3e-05,"031679"
"Flavonifractor.plautii",292800,"S",940,575,1515,0.04568,"031679"
"Clostridioides.difficile",1496,"S",2,308,310,0.00935,"031679"
"Clostridium.baratii",1561,"S",21,13,34,0.00103,"031679"
"Clostridium.butyricum",1492,"S",7,5,12,0.00036,"031679"
"Erysipelatoclostridium.ramosum",1547,"S",814,119,933,0.02813,"031679"
"X.Clostridium..innocuum",1522,"S",241,123,364,0.01098,"031679"
"Akkermansia.muciniphila",239935,"S",6941,965,7906,0.23839,"031679"
"Leptotrichia.wadei",157687,"S",1,1,2,6e-05,"031679"
"Fusobacterium.nucleatum",851,"S",1,0,1,3e-05,"031679"
"Homo.sapiens",9606,"S",460,26,486,0.01465,"031679"
"Faecalibacterium.prausnitzii",853,"S",1,31,32,0.69565,"031683"
"Ruthenibacterium.lactatiformans",1550024,"S",1,3,4,0.08696,"031683"
"Bacteroides.salyersiae",291644,"S",1,0,1,0.02174,"031683"
"Aquirufa.nivalisilvae",2516557,"S",1,0,1,0.02174,"031683"
"Homo.sapiens",9606,"S",1,5,6,0.13043,"031683"
"Finegoldia.magna",1260,"S",1,0,1,0.09091,"032111"
"Acidibrevibacterium.fodinaquatile",1969806,"S",1,1,2,0.18182,"032111"
"Prevotella.nigrescens",28133,"S",1,0,1,0.09091,"032111"
"Homo.sapiens",9606,"S",2,4,6,0.54545,"032111"
"Homo.sapiens",9606,"S",6830,639,7469,0.53823,"032115"
"Flavonifractor.plautii",292800,"S",202,419,621,0.04475,"032115"
"Faecalibacterium.prausnitzii",853,"S",167,890,1057,0.07617,"032115"
"Ruthenibacterium.lactatiformans",1550024,"S",1,1,2,0.00014,"032115"
"Blautia.sp..SC05B48",2479767,"S",58,554,612,0.0441,"032115"
"Blautia.obeum",40520,"S",7,73,80,0.00576,"032115"
"X.Clostridium..scindens",29347,"S",31,116,147,0.01059,"032115"
"X.Ruminococcus..gnavus",33038,"S",12,46,58,0.00418,"032115"
"Anaerostipes.caccae",105841,"S",1,2,3,0.00022,"032115"
"Hungatella.hathewayi",154046,"S",4,2,6,0.00043,"032115"
"Massilistercora.timonensis",2086584,"S",2,8,10,0.00072,"032115"
"Flintibacter.sp..KGMB00164",2610895,"S",1,1,2,0.00014,"032115"
"Dialister.pneumosintes",39950,"S",1,223,224,0.01614,"032115"
"Parvimonas.micra",33033,"S",13,1188,1201,0.08655,"032115"
"X.Clostridium..innocuum",1522,"S",10,37,47,0.00339,"032115"
"Erysipelatoclostridium.ramosum",1547,"S",1,1,2,0.00014,"032115"
"Schaalia.turicensis",131111,"S",18,120,138,0.00994,"032115"
"Corynebacterium.urealyticum",43771,"S",1,9,10,0.00072,"032115"
"Collinsella.aerofaciens",74426,"S",459,1264,1723,0.12416,"032115"
"Gordonibacter.pamelaeae",471189,"S",2,42,44,0.00317,"032115"
"Desulfovibrio.fairfieldensis",44742,"S",4,129,133,0.00958,"032115"
"Sutterella.wadsworthensis",40545,"S",2,21,23,0.00166,"032115"
"Phocaeicola.dorei",357276,"S",50,148,198,0.01427,"032115"
"Bacteroides.caccae",47678,"S",3,8,11,0.00079,"032115"
"Bacteroides.cellulosilyticus",246787,"S",2,7,9,0.00065,"032115"
"Butyricimonas.virosa",544645,"S",7,2,9,0.00065,"032115"
"Odoribacter.splanchnicus",28118,"S",4,2,6,0.00043,"032115"
"Porphyromonas.asaccharolytica",28123,"S",4,2,6,0.00043,"032115"
"Parabacteroides.merdae",46503,"S",1,3,4,0.00029,"032115"
"Alistipes.onderdonkii",328813,"S",1,2,3,0.00022,"032115"
"Fusobacterium.nucleatum",851,"S",2,4,6,0.00043,"032115"
"Homo.sapiens",9606,"S",7532,1448,8980,0.9595,"032117"
"X.Ruminococcus..gnavus",33038,"S",2,11,13,0.00139,"032117"
"Anaerobutyricum.hallii",39488,"S",1,5,6,0.00064,"032117"
"Filifactor.alocis",143361,"S",3,42,45,0.00481,"032117"
"Faecalibacterium.prausnitzii",853,"S",1,9,10,0.00107,"032117"
"Clostridium.sp..C1",1155388,"S",1,6,7,0.00075,"032117"
"Parvimonas.micra",33033,"S",2,57,59,0.0063,"032117"
"Prevotella.intermedia",28131,"S",12,44,56,0.00598,"032117"
"Prevotella.oris",28135,"S",1,2,3,0.00032,"032117"
"Bacteroides.caccae",47678,"S",6,6,12,0.00128,"032117"
"Bacteroides.eggerthii",28111,"S",1,2,3,0.00032,"032117"
"Bacteroides.ovatus",28116,"S",1,3,4,0.00043,"032117"
"Bacteroides.salyersiae",291644,"S",1,2,3,0.00032,"032117"
"Phocaeicola.vulgatus",821,"S",5,17,22,0.00235,"032117"
"Porphyromonas.gingivalis",837,"S",4,6,10,0.00107,"032117"
"Odoribacter.splanchnicus",28118,"S",2,1,3,0.00032,"032117"
"Butyricimonas.virosa",544645,"S",1,0,1,0.00011,"032117"
"Parabacteroides.merdae",46503,"S",1,2,3,0.00032,"032117"
"Barnesiella.viscericola",397865,"S",1,3,4,0.00043,"032117"
"Fusobacterium.nucleatum",851,"S",6,27,33,0.00353,"032117"
"Leptotrichia.sp..oral.taxon.221",712362,"S",3,22,25,0.00267,"032117"
"Leptotrichia.wadei",157687,"S",2,8,10,0.00107,"032117"
"Akkermansia.muciniphila",239935,"S",8,13,21,0.00224,"032117"
"Candidatus.Saccharimonas.aalborgensis",1332188,"S",1,1,2,0.00021,"032117"
"Candidatus.Nanosynbacter.lyticus",2093824,"S",1,7,8,0.00085,"032117"
"Treponema.parvum",138851,"S",1,1,2,0.00021,"032117"
"Dialister.pneumosintes",39950,"S",788,758,1546,0.06982,"032376"
"Phascolarctobacterium.sp..Marseille.Q4147",2823317,"S",10,163,173,0.00781,"032376"
"Selenomonas.sputigena",69823,"S",221,158,379,0.01712,"032376"
"Lachnoanaerobaculum.umeaense",617123,"S",233,198,431,0.01946,"032376"
"X.Clostridium..scindens",29347,"S",157,461,618,0.02791,"032376"
"X.Clostridium..hylemonae",89153,"S",13,4,17,0.00077,"032376"
"X.Ruminococcus..gnavus",33038,"S",51,306,357,0.01612,"032376"
"Anaerostipes.caccae",105841,"S",2,5,7,0.00032,"032376"
"Oscillibacter.sp..MM50",2714355,"S",52,373,425,0.01919,"032376"
"Ruthenibacterium.lactatiformans",1550024,"S",8,30,38,0.00172,"032376"
"Flavonifractor.plautii",292800,"S",7,19,26,0.00117,"032376"
"Flintibacter.sp..KGMB00164",2610895,"S",30,47,77,0.00348,"032376"
"Intestinimonas.butyriciproducens",1297617,"S",1,2,3,0.00014,"032376"
"Limosilactobacillus.mucosae",97478,"S",1,151,152,0.00686,"032376"
"Parvimonas.micra",33033,"S",424,2069,2493,0.11259,"032376"
"Peptoniphilus.harei",54005,"S",20,96,116,0.00524,"032376"
"Finegoldia.magna",1260,"S",14,264,278,0.01255,"032376"
"Murdochiella.vaginalis",1852373,"S",2,9,11,5e-04,"032376"
"X.Clostridium..innocuum",1522,"S",69,198,267,0.01206,"032376"
"Erysipelatoclostridium.ramosum",1547,"S",30,22,52,0.00235,"032376"
"Lancefieldella.parvula",1382,"S",2,33,35,0.00158,"032376"
"Mobiluncus.curtisii",2051,"S",12,6,18,0.00081,"032376"
"Schaalia.turicensis",131111,"S",3,33,36,0.00163,"032376"
"Microlunatus.sagamiharensis",546874,"S",1,2,3,0.00014,"032376"
"Prevotella.oris",28135,"S",334,564,898,0.04055,"032376"
"Prevotella.denticola",28129,"S",280,1628,1908,0.08617,"032376"
"Prevotella.nigrescens",28133,"S",257,1861,2118,0.09565,"032376"
"Prevotella.dentalis",52227,"S",20,36,56,0.00253,"032376"
"Bacteroides.salyersiae",291644,"S",172,258,430,0.01942,"032376"
"Bacteroides.caccae",47678,"S",61,118,179,0.00808,"032376"
"Bacteroides.cellulosilyticus",246787,"S",54,117,171,0.00772,"032376"
"Bacteroides.eggerthii",28111,"S",10,27,37,0.00167,"032376"
"Bacteroides.uniformis",820,"S",9,239,248,0.0112,"032376"
"Phocaeicola.dorei",357276,"S",258,252,510,0.02303,"032376"
"Phocaeicola.vulgatus",821,"S",1,1,2,9e-05,"032376"
"Parabacteroides.goldsteinii",328812,"S",92,264,356,0.01608,"032376"
"Parabacteroides.merdae",46503,"S",12,73,85,0.00384,"032376"
"Parabacteroides.distasonis",823,"S",1,279,280,0.01265,"032376"
"Odoribacter.splanchnicus",28118,"S",131,31,162,0.00732,"032376"
"Butyricimonas.faecalis",2093856,"S",25,32,57,0.00257,"032376"
"Alistipes.onderdonkii",328813,"S",66,138,204,0.00921,"032376"
"Alistipes.shahii",328814,"S",34,55,89,0.00402,"032376"
"Schlegelella.thermodepolymerans",215580,"S",1,836,837,0.0378,"032376"
"Leptotrichia.wadei",157687,"S",401,323,724,0.0327,"032376"
"Fusobacterium.nucleatum",851,"S",450,317,767,0.03464,"032376"
"Homo.sapiens",9606,"S",3235,1207,4442,0.20061,"032376"
"Methanobrevibacter.smithii",2173,"S",1,0,1,5e-05,"032376"
"Dialister.pneumosintes",39950,"S",34,43,77,0.09367,"032388"
"Phascolarctobacterium.sp..Marseille.Q4147",2823317,"S",1,2,3,0.00365,"032388"
"Selenomonas.sputigena",69823,"S",9,9,18,0.0219,"032388"
"Lachnoanaerobaculum.umeaense",617123,"S",9,9,18,0.0219,"032388"
"X.Clostridium..scindens",29347,"S",6,24,30,0.0365,"032388"
"X.Clostridium..hylemonae",89153,"S",1,1,2,0.00243,"032388"
"X.Ruminococcus..gnavus",33038,"S",1,9,10,0.01217,"032388"
"Oscillibacter.sp..MM50",2714355,"S",1,12,13,0.01582,"032388"
"Ruthenibacterium.lactatiformans",1550024,"S",1,3,4,0.00487,"032388"
"Flintibacter.sp..KGMB00164",2610895,"S",1,2,3,0.00365,"032388"
"Parvimonas.micra",33033,"S",15,88,103,0.1253,"032388"
"Finegoldia.magna",1260,"S",1,15,16,0.01946,"032388"
"Peptoniphilus.harei",54005,"S",1,3,4,0.00487,"032388"
"X.Clostridium..innocuum",1522,"S",2,17,19,0.02311,"032388"
"Erysipelatoclostridium.ramosum",1547,"S",2,3,5,0.00608,"032388"
"Prevotella.denticola",28129,"S",16,113,129,0.15693,"032388"
"Prevotella.oris",28135,"S",15,28,43,0.05231,"032388"
"Prevotella.nigrescens",28133,"S",2,16,18,0.0219,"032388"
"Bacteroides.salyersiae",291644,"S",6,6,12,0.0146,"032388"
"Bacteroides.caccae",47678,"S",4,5,9,0.01095,"032388"
"Bacteroides.cellulosilyticus",246787,"S",4,6,10,0.01217,"032388"
"Phocaeicola.dorei",357276,"S",13,9,22,0.02676,"032388"
"Parabacteroides.goldsteinii",328812,"S",4,8,12,0.0146,"032388"
"Parabacteroides.merdae",46503,"S",1,4,5,0.00608,"032388"
"Odoribacter.splanchnicus",28118,"S",6,1,7,0.00852,"032388"
"Alistipes.shahii",328814,"S",1,1,2,0.00243,"032388"
"Fusobacterium.nucleatum",851,"S",18,15,33,0.04015,"032388"
"Leptotrichia.wadei",157687,"S",14,9,23,0.02798,"032388"
"Homo.sapiens",9606,"S",111,49,160,0.19465,"032388"
"Homo.sapiens",9606,"S",6560,686,7246,0.67644,"032513"
"X.Ruminococcus..gnavus",33038,"S",99,1316,1415,0.13209,"032513"
"X.Clostridium..hylemonae",89153,"S",7,25,32,0.00299,"032513"
"X.Clostridium..scindens",29347,"S",1,13,14,0.00131,"032513"
"Flavonifractor.plautii",292800,"S",1,54,55,0.00513,"032513"
"Ruthenibacterium.lactatiformans",1550024,"S",1,13,14,0.00131,"032513"
"Flintibacter.sp..KGMB00164",2610895,"S",4,20,24,0.00224,"032513"
"Clostridium.perfringens",1502,"S",1,11,12,0.00112,"032513"
"Limosilactobacillus.fermentum",1613,"S",2,45,47,0.00439,"032513"
"X.Clostridium..innocuum",1522,"S",2,11,13,0.00121,"032513"
"Phocaeicola.vulgatus",821,"S",133,1251,1384,0.1292,"032513"
"Phocaeicola.dorei",357276,"S",5,44,49,0.00457,"032513"
"Bacteroides.salyersiae",291644,"S",14,115,129,0.01204,"032513"
"Bacteroides.uniformis",820,"S",7,123,130,0.01214,"032513"
"Bacteroides.intestinalis",329854,"S",3,8,11,0.00103,"032513"
"Parabacteroides.merdae",46503,"S",10,79,89,0.00831,"032513"
"Tannerella.forsythia",28112,"S",1,0,1,9e-05,"032513"
"Alistipes.finegoldii",214856,"S",1,33,34,0.00317,"032513"
"Odoribacter.splanchnicus",28118,"S",2,4,6,0.00056,"032513"
"Candidatus.Methanoplasma.termitum",1577791,"S",1,0,1,9e-05,"032513"
"Prevotella.sp..oral.taxon.299",652716,"S",3186,329,3515,0.13378,"032515"
"Prevotella.enoeca",76123,"S",5,0,5,0.00019,"032515"
"Bacteroides.caccae",47678,"S",589,1771,2360,0.08982,"032515"
"Phocaeicola.dorei",357276,"S",332,350,682,0.02596,"032515"
"Parabacteroides.merdae",46503,"S",34,211,245,0.00932,"032515"
"Parabacteroides.distasonis",823,"S",2,592,594,0.02261,"032515"
"Dialister.pneumosintes",39950,"S",855,767,1622,0.06173,"032515"
"Veillonella.parvula",29466,"S",16,215,231,0.00879,"032515"
"Selenomonas.sputigena",69823,"S",199,74,273,0.01039,"032515"
"Clostridium.perfringens",1502,"S",380,290,670,0.0255,"032515"
"Hungatella.hathewayi",154046,"S",3,0,3,0.00011,"032515"
"X.Ruminococcus..gnavus",33038,"S",59,257,316,0.01203,"032515"
"X.Ruminococcus..torques",33039,"S",6,55,61,0.00232,"032515"
"Lacrimispora.saccharolytica",84030,"S",13,67,80,0.00304,"032515"
"X.Clostridium..scindens",29347,"S",2,4,6,0.00023,"032515"
"Lachnoanaerobaculum.umeaense",617123,"S",1,2,3,0.00011,"032515"
"Flavonifractor.plautii",292800,"S",8,43,51,0.00194,"032515"
"Ruthenibacterium.lactatiformans",1550024,"S",2,4,6,0.00023,"032515"
"Flintibacter.sp..KGMB00164",2610895,"S",1,1,2,8e-05,"032515"
"Parvimonas.micra",33033,"S",65,1070,1135,0.0432,"032515"
"Erysipelatoclostridium.ramosum",1547,"S",41,34,75,0.00285,"032515"
"X.Clostridium..innocuum",1522,"S",6,16,22,0.00084,"032515"
"Corynebacterium.matruchotii",43768,"S",2,3,5,0.00019,"032515"
"Fusobacterium.nucleatum",851,"S",2060,1597,3657,0.13919,"032515"
"Homo.sapiens",9606,"S",9663,978,10641,0.405,"032515"
"Homo.sapiens",9606,"S",7971,1277,9248,0.99526,"032517"
"Faecalibacterium.prausnitzii",853,"S",2,14,16,0.00172,"032517"
"Blautia.sp..SC05B48",2479767,"S",1,9,10,0.00108,"032517"
"Collinsella.aerofaciens",74426,"S",4,6,10,0.00108,"032517"
"Desulfovibrio.fairfieldensis",44742,"S",1,1,2,0.00022,"032517"
"Phocaeicola.dorei",357276,"S",1,1,2,0.00022,"032517"
"Prevotella.sp..oral.taxon.299",652716,"S",2,0,2,0.00022,"032517"
"Phocaeicola.dorei",357276,"S",1,5,6,0.11538,"032527"
"Prevotella.oris",28135,"S",2,1,3,0.05769,"032527"
"Prevotella.nigrescens",28133,"S",1,1,2,0.03846,"032527"
"Fusobacterium.nucleatum",851,"S",1,8,9,0.17308,"032527"
"Nosocomiicoccus.ampullae",489910,"S",2,3,5,0.09615,"032527"
"Corynebacterium.urealyticum",43771,"S",1,8,9,0.17308,"032527"
"Akkermansia.muciniphila",239935,"S",2,2,4,0.07692,"032527"
"Homo.sapiens",9606,"S",7,2,9,0.17308,"032527"
"Bacteroides.cellulosilyticus",246787,"S",84,5933,6017,0.14406,"032766"
"Bacteroides.salyersiae",291644,"S",1,38,39,0.00093,"032766"
"Phocaeicola.dorei",357276,"S",1128,6052,7180,0.17191,"032766"
"Porphyromonas.sp..oral.taxon.275",712435,"S",2312,2165,4477,0.10719,"032766"
"Odoribacter.splanchnicus",28118,"S",887,775,1662,0.03979,"032766"
"Alistipes.onderdonkii",328813,"S",22,230,252,0.00603,"032766"
"Fusobacterium.nucleatum",851,"S",2,4338,4340,0.10391,"032766"
"Fusobacterium.hwasookii",1583098,"S",1,6801,6802,0.16286,"032766"
"Veillonella.parvula",29466,"S",465,4724,5189,0.12424,"032766"
"Ruthenibacterium.lactatiformans",1550024,"S",1304,1549,2853,0.06831,"032766"
"Flavonifractor.plautii",292800,"S",124,434,558,0.01336,"032766"
"Blautia.argi",1912897,"S",1,63,64,0.00153,"032766"
"X.Ruminococcus..gnavus",33038,"S",21,137,158,0.00378,"032766"
"Clostridium.baratii",1561,"S",14,20,34,0.00081,"032766"
"X.Clostridium..innocuum",1522,"S",42,66,108,0.00259,"032766"
"Erysipelatoclostridium.ramosum",1547,"S",4,3,7,0.00017,"032766"
"Homo.sapiens",9606,"S",1788,232,2020,0.04836,"032766"
"Phocaeicola.vulgatus",821,"S",7411,5843,13254,0.34354,"032768"
"Phocaeicola.dorei",357276,"S",1490,1181,2671,0.06923,"032768"
"Bacteroides.caecimuris",1796613,"S",1,5,6,0.00016,"032768"
"Prevotella.copri",165179,"S",2353,592,2945,0.07633,"032768"
"Alistipes.onderdonkii",328813,"S",1087,590,1677,0.04347,"032768"
"Veillonella.parvula",29466,"S",44,645,689,0.01786,"032768"
"X.Ruminococcus..gnavus",33038,"S",1263,2326,3589,0.09303,"032768"
"Anaerostipes.caccae",105841,"S",24,15,39,0.00101,"032768"
"Flavonifractor.plautii",292800,"S",890,456,1346,0.03489,"032768"
"Clostridioides.difficile",1496,"S",1,190,191,0.00495,"032768"
"Clostridium.baratii",1561,"S",7,3,10,0.00026,"032768"
"Clostridium.butyricum",1492,"S",4,2,6,0.00016,"032768"
"Erysipelatoclostridium.ramosum",1547,"S",1049,169,1218,0.03157,"032768"
"X.Clostridium..innocuum",1522,"S",288,135,423,0.01096,"032768"
"Akkermansia.muciniphila",239935,"S",8898,1456,10354,0.26837,"032768"
"Escherichia.coli",562,"S",1,7,8,0.00021,"032768"
"Morganella.morganii",582,"S",1,2,3,8e-05,"032768"
"Homo.sapiens",9606,"S",123,20,143,0.00371,"032768"
"Dialister.pneumosintes",39950,"S",16,17,33,0.07674,"032778"
"Selenomonas.sputigena",69823,"S",4,4,8,0.0186,"032778"
"Lachnoanaerobaculum.umeaense",617123,"S",4,3,7,0.01628,"032778"
"X.Clostridium..scindens",29347,"S",4,12,16,0.03721,"032778"
"Oscillibacter.sp..MM50",2714355,"S",2,8,10,0.02326,"032778"
"Parvimonas.micra",33033,"S",12,62,74,0.17209,"032778"
"Prevotella.nigrescens",28133,"S",8,50,58,0.13488,"032778"
"Prevotella.denticola",28129,"S",4,20,24,0.05581,"032778"
"Prevotella.oris",28135,"S",4,5,9,0.02093,"032778"
"Bacteroides.salyersiae",291644,"S",3,10,13,0.03023,"032778"
"Bacteroides.cellulosilyticus",246787,"S",1,5,6,0.01395,"032778"
"Phocaeicola.dorei",357276,"S",6,6,12,0.02791,"032778"
"Parabacteroides.goldsteinii",328812,"S",2,6,8,0.0186,"032778"
"Odoribacter.splanchnicus",28118,"S",2,0,2,0.00465,"032778"
"Alistipes.onderdonkii",328813,"S",1,0,1,0.00233,"032778"
"Bradyrhizobium.sp..PSBB068",2715960,"S",1,26,27,0.06279,"032778"
"Fusobacterium.nucleatum",851,"S",6,6,12,0.02791,"032778"
"Leptotrichia.wadei",157687,"S",3,3,6,0.01395,"032778"
"Homo.sapiens",9606,"S",69,27,96,0.22326,"032778"
"Homo.sapiens",9606,"S",12539,760,13299,0.7678,"033086"
"X.Ruminococcus..gnavus",33038,"S",27,1182,1209,0.0698,"033086"
"X.Clostridium..hylemonae",89153,"S",3,35,38,0.00219,"033086"
"Blautia.sp..SC05B48",2479767,"S",1,37,38,0.00219,"033086"
"Faecalibacterium.prausnitzii",853,"S",1,91,92,0.00531,"033086"
"Flintibacter.sp..KGMB00164",2610895,"S",1,15,16,0.00092,"033086"
"Limosilactobacillus.fermentum",1613,"S",1,43,44,0.00254,"033086"
"Lawsonella.clevelandensis",1528099,"S",1,12,13,0.00075,"033086"
"Collinsella.aerofaciens",74426,"S",1,27,28,0.00162,"033086"
"Phocaeicola.vulgatus",821,"S",52,1737,1789,0.10329,"033086"
"Phocaeicola.dorei",357276,"S",3,95,98,0.00566,"033086"
"Bacteroides.intestinalis",329854,"S",3,32,35,0.00202,"033086"
"Bacteroides.salyersiae",291644,"S",3,90,93,0.00537,"033086"
"Parabacteroides.merdae",46503,"S",4,96,100,0.00577,"033086"
"Alistipes.shahii",328814,"S",2,64,66,0.00381,"033086"
"Alistipes.onderdonkii",328813,"S",1,38,39,0.00225,"033086"
"Odoribacter.splanchnicus",28118,"S",5,40,45,0.0026,"033086"
"Akkermansia.muciniphila",239935,"S",12,258,270,0.01559,"033086"
"Escherichia.coli",562,"S",1,510,511,0.02431,"033088"
"Cardiobacterium.hominis",2718,"S",1,318,319,0.01517,"033088"
"Campylobacter.ureolyticus",827,"S",29,154,183,0.0087,"033088"
"Desulfovibrio.fairfieldensis",44742,"S",3,150,153,0.00728,"033088"
"Selenomonas.sputigena",69823,"S",12,50,62,0.00295,"033088"
"Phascolarctobacterium.faecium",33025,"S",1,79,80,0.00381,"033088"
"Lachnoanaerobaculum.umeaense",617123,"S",22,205,227,0.0108,"033088"
"X.Ruminococcus..gnavus",33038,"S",17,103,120,0.00571,"033088"
"X.Ruminococcus..torques",33039,"S",3,32,35,0.00166,"033088"
"Anaerobutyricum.hallii",39488,"S",4,21,25,0.00119,"033088"
"Blautia.obeum",40520,"S",1,13,14,0.00067,"033088"
"Blautia.sp..SC05B48",2479767,"S",1,14,15,0.00071,"033088"
"Anaerostipes.hadrus",649756,"S",2,24,26,0.00124,"033088"
"Faecalibacterium.prausnitzii",853,"S",2,34,36,0.00171,"033088"
"Filifactor.alocis",143361,"S",33,662,695,0.03306,"033088"
"Flintibacter.sp..KGMB00164",2610895,"S",1,2,3,0.00014,"033088"
"Bulleidia.sp..zg.1006",2806552,"S",22,209,231,0.01099,"033088"
"Erysipelatoclostridium.ramosum",1547,"S",2,5,7,0.00033,"033088"
"X.Clostridium..innocuum",1522,"S",1,8,9,0.00043,"033088"
"Parvimonas.micra",33033,"S",7,359,366,0.01741,"033088"
"Peptoniphilus.harei",54005,"S",2,30,32,0.00152,"033088"
"Corynebacterium.matruchotii",43768,"S",1,11,12,0.00057,"033088"
"Lawsonella.clevelandensis",1528099,"S",3,16,19,9e-04,"033088"
"Lancefieldella.parvula",1382,"S",12,32,44,0.00209,"033088"
"Collinsella.aerofaciens",74426,"S",2,5,7,0.00033,"033088"
"Prevotella.intermedia",28131,"S",298,1355,1653,0.07862,"033088"
"Prevotella.oris",28135,"S",64,136,200,0.00951,"033088"
"Prevotella.enoeca",76123,"S",14,42,56,0.00266,"033088"
"Prevotella.nigrescens",28133,"S",5,38,43,0.00205,"033088"
"Prevotella.veroralis",28137,"S",2,7,9,0.00043,"033088"
"Prevotella.sp..WR041",2801997,"S",1,0,1,5e-05,"033088"
"Phocaeicola.vulgatus",821,"S",114,245,359,0.01708,"033088"
"Phocaeicola.dorei",357276,"S",4,6,10,0.00048,"033088"
"Bacteroides.caccae",47678,"S",53,42,95,0.00452,"033088"
"Bacteroides.eggerthii",28111,"S",11,22,33,0.00157,"033088"
"Bacteroides.salyersiae",291644,"S",8,18,26,0.00124,"033088"
"Bacteroides.ovatus",28116,"S",2,12,14,0.00067,"033088"
"Bacteroides.uniformis",820,"S",1,5,6,0.00029,"033088"
"Porphyromonas.gingivalis",837,"S",80,60,140,0.00666,"033088"
"Porphyromonas.sp..oral.taxon.275",712435,"S",25,46,71,0.00338,"033088"
"Porphyromonas.asaccharolytica",28123,"S",3,2,5,0.00024,"033088"
"Parabacteroides.merdae",46503,"S",9,29,38,0.00181,"033088"
"Tannerella.forsythia",28112,"S",3,0,3,0.00014,"033088"
"Alistipes.finegoldii",214856,"S",9,28,37,0.00176,"033088"
"Alistipes.onderdonkii",328813,"S",6,12,18,0.00086,"033088"
"Alistipes.shahii",328814,"S",1,6,7,0.00033,"033088"
"Odoribacter.splanchnicus",28118,"S",12,6,18,0.00086,"033088"
"Butyricimonas.virosa",544645,"S",5,2,7,0.00033,"033088"
"Barnesiella.viscericola",397865,"S",3,9,12,0.00057,"033088"
"Capnocytophaga.gingivalis",1017,"S",6,26,32,0.00152,"033088"
"Fusobacterium.nucleatum",851,"S",178,493,671,0.03192,"033088"
"Leptotrichia.wadei",157687,"S",117,310,427,0.02031,"033088"
"Leptotrichia.sp..oral.taxon.221",712362,"S",56,153,209,0.00994,"033088"
"Leptotrichia.sp..oral.taxon.212",712357,"S",8,46,54,0.00257,"033088"
"Akkermansia.muciniphila",239935,"S",90,392,482,0.02293,"033088"
"Candidatus.Saccharimonas.aalborgensis",1332188,"S",48,28,76,0.00361,"033088"
"Candidatus.Nanosynbacter.lyticus",2093824,"S",28,105,133,0.00633,"033088"
"Treponema.parvum",138851,"S",15,32,47,0.00224,"033088"
"Cloacibacillus.porcorum",1197717,"S",5,12,17,0.00081,"033088"
"Homo.sapiens",9606,"S",9569,3182,12751,0.6065,"033088"
"Methanobrevibacter.smithii",2173,"S",1,1,2,1e-04,"033088"
"Phocaeicola.vulgatus",821,"S",1287,1127,2414,0.11067,"033090"
"Phocaeicola.dorei",357276,"S",1,0,1,5e-05,"033090"
"Bacteroides.caccae",47678,"S",435,706,1141,0.05231,"033090"
"Bacteroides.uniformis",820,"S",15,322,337,0.01545,"033090"
"Parabacteroides.merdae",46503,"S",449,540,989,0.04534,"033090"
"Parabacteroides.goldsteinii",328812,"S",115,50,165,0.00756,"033090"
"Alistipes.shahii",328814,"S",57,157,214,0.00981,"033090"
"Alistipes.communis",2585118,"S",25,70,95,0.00436,"033090"
"Butyricimonas.faecalis",2093856,"S",58,130,188,0.00862,"033090"
"Barnesiella.viscericola",397865,"S",100,37,137,0.00628,"033090"
"Oscillibacter.sp..MM50",2714355,"S",487,1652,2139,0.09806,"033090"
"Oscillibacter.sp..MM35",2714353,"S",4,11,15,0.00069,"033090"
"Oscillibacter.sp..MM59",2714358,"S",3,8,11,5e-04,"033090"
"Faecalibacterium.prausnitzii",853,"S",726,1590,2316,0.10618,"033090"
"Ruminococcus.bicirculans",1160721,"S",100,154,254,0.01164,"033090"
"Flavonifractor.plautii",292800,"S",147,117,264,0.0121,"033090"
"Ruthenibacterium.lactatiformans",1550024,"S",68,48,116,0.00532,"033090"
"Dysosmobacter.sp..Marseille.Q4140",2830675,"S",11,28,39,0.00179,"033090"
"Fastidiosipila.sanguinis",236753,"S",6,13,19,0.00087,"033090"
"Coprococcus.catus",116085,"S",26,33,59,0.0027,"033090"
"Coprococcus.comes",410072,"S",17,33,50,0.00229,"033090"
"Blautia.sp..SC05B48",2479767,"S",33,82,115,0.00527,"033090"
"Anaerobutyricum.hallii",39488,"S",24,47,71,0.00325,"033090"
"X.Ruminococcus..torques",33039,"S",21,39,60,0.00275,"033090"
"X.Ruminococcus..gnavus",33038,"S",2,2,4,0.00018,"033090"
"Lacrimispora.saccharolytica",84030,"S",9,14,23,0.00105,"033090"
"Lachnospira.eligens",39485,"S",9,5,14,0.00064,"033090"
"Anaerostipes.hadrus",649756,"S",7,15,22,0.00101,"033090"
"Flintibacter.sp..KGMB00164",2610895,"S",20,10,30,0.00138,"033090"
"Massilistercora.timonensis",2086584,"S",14,24,38,0.00174,"033090"
"Intestinimonas.butyriciproducens",1297617,"S",6,5,11,5e-04,"033090"
"Clostridium.baratii",1561,"S",1,5,6,0.00028,"033090"
"Hungatella.hathewayi",154046,"S",6,1,7,0.00032,"033090"
"X.Clostridium..innocuum",1522,"S",67,75,142,0.00651,"033090"
"Faecalitalea.cylindroides",39483,"S",5,19,24,0.0011,"033090"
"Collinsella.aerofaciens",74426,"S",25,10,35,0.0016,"033090"
"Rheinheimera.sp..F8",1763998,"S",1,0,1,5e-05,"033090"
"Fusobacterium.nucleatum",851,"S",1,3,4,0.00018,"033090"
"Akkermansia.muciniphila",239935,"S",3,0,3,0.00014,"033090"
"Cloacibacillus.porcorum",1197717,"S",3,1,4,0.00018,"033090"
"Homo.sapiens",9606,"S",8977,1235,10212,0.46816,"033090"
"Methanobrevibacter.smithii",2173,"S",4,0,4,0.00018,"033090"
